######################################################################################################################################################
######################################################################################################################################################
################################..........#################........####.....#######################################...........########################
##########################..###..........#################..........###......######################################..............#####################
##########...############....##..........################............###.....###########..#########################...............######....##########
#######.......###########....##.........#################.............##.....##########....########################................####......#########
######.........##########....#.........#################..............###...##########.....########################................####......#########
#####..........###########............##################..............################.....#######################.................####......#########
####...........#############..........##################.............#########..######......#####################..................####......#########
####...........##############........###################............#########....#####......#######...##########...................###.......#########
####..........###############.......####################...........##########.....####......######.....########.....................##........########
####.........#################......####################......###############.....#####....######.......######.......#..............#.........########
####........###################.....#####################....################.....###############........#..........#..............#..........########
####.......#####################....##########################################...################...................#.........................########
####.......#######################.##############################################################...................#.........................########
####.....########################################################################################..................##.........................########
#####...#########################################################################################..................###...........#............########
####################################################################################.############...................###........####...........########
##.##############################################################################################....###.............##......######............#######
##..##############################################################################################..#####......#.............######............#######
##...######################################################..############################......############.................########...........#######
##...#####################################################....#########################.........############.................#######...........#######
##...#####################################################....#######################............###########.................########..........#######
##...######################################################..#######################..............##########.......#.........########.........#...####
##...############....####################......#####################################...............#########....#...........#########..............###
##...###########.......###############..........#####################.....##########.................#######...............###########.............###
##...#########..........###........#.............##################........#########..................#######..............################........###
##....#.#####............#........................###############..........########....................#######............#################........###
##....#######.....................................#############............#######......................#######..........####..###########........####
##....####.#......................................############.............######........###............#########.........##....##########........####
##................................................###########..............######.......#####............#########........##....########..........####
##...............................................##########...............########.....######............############....####..########...........####
##..............................................##########................#########...######..............############################............####
###.....................................##.....##########.................##################..............###########################.............####
##.#..............#....................####....#########..................##################..............###########################.............####
##.#..................................######.............................####################.............###########################.............####
##.....................................######.........................#######################..............####.....#################.............####
##.....................................######........................#########################.............#.........################............#####
##.....................................######.......................##########################........................################..........######
##......................................######.....................###########################........................################...........#####
####...............##....................######.........................#######################......................#################...........#####
####..............######..................######.........................#######################.................#####################...........#####
####..............########.................######.........................#######################...............#######################.........######
####..............#########.................#######........#..............#######################................#######################.......#######
####..............#########.................####################..........########################........................###############.....########
####..............##########................###################...........#########################........................###############...###.#####
####.......##....###########................####################..........#######################...........................####################..####
#####......##################...............########################......###################................................##################...####
######....###################...............########################......##################.................................##################...####
#######..####################..............#########################......#################.................................##################....####
#############################.............##########################......################................................####################.....###
#############################............##########################......################...............................######################.....###
##############################.........############################......#################.............................#######################.....###
#################################################..################.....##################...........................##########################...####
###############....#########..#####################################.....#######################.....................######.....#######################
##############......#######....####################################....#########################.......#...........######.......######################
#############.......######.....########.......######....############....#########################...........#......######........#####################
#############........#####.....######..........####......#########......#######..################...........##.....######.........####################
##.###########.......###.......#####............##.......#######.........#####....###########.###..........####...#######..........###################
##..###########...............#####......................######...........####....###############........################............#################
##...###########.............#####.......................######...........####.....##############........#################.............###############
##....##########............#####.......................#######...........####.....##############.......#####.#################.........##############
##.......#######...........######..................############...........####.....######...####........#######################............###....####
##........####............######.............#....##############..........#####...######...............######################......................###
##........###............########.................###############.........#############...............######################.......................###
##.......###............##########...............##################.......#############...............######################......................####
##......####...........############.............#####################....#############...............######################.......................####
##.....###............#############............#######################################...............######################......................#####
#########............###############..........#######################################...............########..############........................####
########.............#####################...#######################################............###########....###########................#.......####
########.............##############################################################..........#############......##########................##.......###
########.............##############################################################..........###########.........#######.................####......###
#########............################################..############################..........##########..........#####..................#####.....####
#######...#.##........##...#########################....###########################..........#########...........####...................####......####
######.....####.......#.....########################...############################..........#########...##......####..................####......#####
######.....#####.............#######...#############..##############################.........#########..###......####..................###.......#####
######......####..............#####.....##############################...############........##############.....######...#.......................#####
######.......##................###.......######################...##......############.......###############...###########........................####
######.........................##........#####################...............############...##############################........................####
######.......#.................##........####################....................#########################################.........................###
######........................###.........##################......................##.....###########################..####..........................##
######.....................#######........################................................#########################....###..........................##
######..................###########.......##############...................................#######################.....####............#............##
######.................#############.....##############....................................#######################.....##########...########........##
######................################################...........##.........................########.############......#######################.....###
######........#......#################################.........#####........................#####################......###############################
######.......##.....#####.....########################.........#######..............#.......#####################......###############################
#######.....####...#####.......#######################........###..####.........#######......####################.....################################
########...############.........#######################......###....####################.....###...###############...#################################
#######################..........###############################....####################............##################################################
#######################...........##############################....####################............##################################################
#######################...........###############################....###################............##################################################
#######################............##############################.....###################...........######################..##########################
#######################............###################...#########.....###################.........######################....#########################
#######################............##################.....######........###################........#####################.....#########################
######################...............###############.....................###################......############..########.....#########################
##################....................#########...........................###################....############....########...##########################
##.#############......................########....................#........###################..#############....#####################################
##....#########.......................#######...............................##################################..######################################
##.....######.........................######................................##########################################################################
##.....##............................#######.................................#########..##############################################################
##..............................###########......................................####....#############################################################
##.............................###########........................................###......###########################################################
##...................##........###########................#........................##........#########################################################
##...................###........#########.......#......#...........................##..................###############################################
##....................##........#########..........................................##...................##############################################
##..............................#########.........................................####..................##############################################
##..............................#########..........................##............#####..................##############################################
##..............................#########.........................####...........#####.................###############################################
##...............................########........................######..........######................###############################################
##...............................########......................##############...########...............###..........#################...##############
##..............................########.....................############################....#.......................###############........##########
##.......................###############.....................#################################.......................##############..........#########
##......................###############.................#.....################################........................#############..........#########
##....#............####################.......................##.....#########################.........................#############........##########
##....##.......########################.................##............########################..........................#####.#######......###########
##....###....##########################.......###.......#.............#########################..........................#############################
##...##################################......####........#............##########################.........................#############################
##..##############################..........######...................############################........................#############################
################################..........#########.................######################################................############################
#############......############..........############..............########################################...............#############...############
############........###########..........#############............##########################################...............###########......##########
##########..........###########.........###############..........###########################################................##########.......#########
#########..........###########..........#################......#######.#####################################.................########.........########
########..........###########..........##################......###########################################....................######...........#######
########...........#########...........##################........#################################..#####.....................######............######
########..............#####...........###################.........###############################....###......................######...............###
########...............####............##################..........##############################.............................######................##
########................####..............###############..........##############################.............................#######...............##
########.................####..............###############.........###############################............................########..............##
########..................#####............################........################################...........................##########............##
##........................####..............###############........#################################..........................#############.........##
##.................................................#########......##################################......#....................#############........##
##..................#...............................########.......############....#################......##...................#######################
##.................#.......................................#........##########......###############.......######................######################
##..................................................................##########......##############.......########................#####################
##.....................................................................#######......##############........########...............#####################
##......................................................................######......##############........#########..............#####################
##................................###........................###.........#####.....################........##########...........######################
##...............................######.....................#####........######...##################........##########.........#######################
##.............................#########...................#######......#############################........########.........########################
##....#####....................#############................##########################################.......########.........########################
##....#####...................################..............###########################################......########.........########################
##.....####..................####################..........###########################################################........########################
##.....###################################################################################################################....########################
##.....###################################################################################################################....########################
####..#####################################################################################################################..#########################
######################################################################################################################################################
######################################################################################################################################################
######################################################################################################################################################
