###########################################################################
###########################################################################
#################.........###.....#############.........................###
####################.....#####....####...#######.......................####
#####################...#####......##......######......................####
############################.......#..........###.....................#####
###########################.........................................#######
##....##########.....######........................................########
##.....########........####.......................................#########
##.........###...........#........................................#########
##................................................................#########
##...................................##...........................#########
##............................########.............................########
##............................#######..............................########
##............................######..............#.................#######
##............................#####................#.................######
##............................#####................##.................#####
##...........####.............#####...............####.................####
##............####....#.......####...............######................####
##............###########.....###................######................####
##.............###########....###.....#..........#####.................####
##..............##########....##.......#.........#####.................####
###..............#######.......#......#..........####..................####
####..............#..........................#...####..................####
#####.......................................###..####..........###.....####
######......................................#########..........#####...####
#######......................................########...........#####..####
#########....................................########............#####.####
##########.....####.............................######............#########
###########...#######.......................#.....######...........########
####################...............................######..............####
##.##############..................................#####................###
##..###.....####.................#####.............#####................###
##..##.......###..........############.............#####................###
##.###........###........##########..................####..............####
######.........##.......#########.....................####............#####
#######........###.....########.........................###..........######
#######........###....#########...........#..............##.........#######
#######........#.....##########...........................#........########
##..###.............#####.#####..........##.......................#########
##.####............############........####........................########
#######.......#....############.....#######........................########
#######...........#############....#########.......................########
########..........#############....#########.......................########
#########........##############....############....................########
########........###############....############.....................#######
#######........################....#############.....................######
##....#.......####....##########...##############......................####
##..........#####.........#####....################..#..................###
##..........####...........###.....##################....#..............###
##..........###....................###############.....................####
##.........###.....................##############.......................###
##........####........#............##############........................##
##.........###....................##############...................##....##
##..........##...................###############...............######....##
######...........................#########.#####..............########...##
#######.........................#########...####..............#############
##########....................###########...####................###########
###########...................##########....####.................##########
#####..#.....................###########....###..................##########
####........................#####...####.........................##########
####.......................######....####.........................#########
####.......................#######...###..........................#########
####........................###########....................#.......########
####........................###########..............................######
####........................###########...............................#####
####.......................##########.........#........................####
#####....####.........##############.........###........................###
#############........##############........######........................##
##############.........############........############......#......#....##
###############.........#####..####.......##############....####.........##
################.........###....###.......######################.........##
####################.....###....###.......#######################.....#####
###########################################################################
###########################################################################
