###########################################################################
###########################################################################
##....###..........................###....#################################
##....####..............##..........#....##############################.###
##....####..............#########....#....########################.####..##
##.......................########.........####......#######################
##.......................#######............#........######################
##.......................######.......................############..#######
##...#....................####........................###########....######
##...#...................#....#.......................##########.....######
##...................................................###########......#####
##...................................#................##########.......####
##...........................#..........................########.......####
##.......#.........#........#............................########.......###
##................###........#............................########.......##
##...............####.....................................#########......##
#######.........#####.....................................##########.....##
######..........######.....................................#########.....##
#####...........#####......................................#########.....##
##.#............####.......................................#########.....##
##.............####.........................................########.....##
##............####...........................................#######.....##
##............###................................#...........#######.....##
##............###................................###..........######.....##
##.............##...............................######........#######....##
##.............###..............................######........########..###
##.............####................................####......##############
####...........#####................................#######################
#####..........###.............#######............#..######################
######.........##..............#######...............#######...############
#######.......##..............########..............######.........########
##.#####.....####.............#########.....##############..........#######
##..##############............###########################...........#######
##...##############...........##########################............#######
##....################..........#############.....#####............########
##....#################..........###########.......####...........#########
##....#################..........#########..........###...........#########
##....##################.........#####..............###...........#########
##...####################........###...............####...........#########
##..#####################........##..............######...........#########
##...####################........##............#######...........#######.##
##...####################........##............######............##########
##....#################........................####.............###########
##....#########...####...........................................##########
##.....#######......#.............................................#########
##.....######.....................................................#########
##......####.....................................................##########
##......####....................................................###########
##......####.......................#..........................#############
###...............#...............###........................##############
####.............#..........................................###############
####..........#.##..#..................................#..#################
####....................#.................................##########..#####
###............................................................####....####
##................................................##............###.....###
##..............................................#####............###....###
##.............#...............................#######............###..####
##..................#...........................#####............##########
##.................###..........................####.............##########
##.................####...............#.........###..............##########
##.................####...........#............###........###...###########
##...........##########.........###...........###........#####.############
##.........##########...........###..........###......#####################
##........#########.............###......#######.....######################
##.......#########........##.....##.....#######.....#######################
##........########......##..........#...######.....########################
##........########......................#####.....#########################
##........#######.......................#####.....###...###################
##........######......#.................#####.....##.....##################
##........#####......##.................#####.....##.....##################
##...#...#####.......###.......##.......######...####...####.#######...####
##.###########.......####.....#######..#############################....###
##############......######...#######################################....###
###########################################################################
###########################################################################
