######################################################################################################################################################
######################################################################################################################################################
#########################...............####################................######################################...........#########################
#########################...............###################.................##############..######################...........#########################
#########################..............####################..................############....######################...........########################
######........###########..............###################....................##########.....########################..........#######################
#####..........##########..............###.##############......................#########.....########################...........##########....########
#####..........###########..............#################...............#.......########....#.########################...........########......#######
#####..........###########...............################.............#####.....########.........#################................######.......#######
####...........##############............################........#...######......#######..........#....########...................#####........#######
##.............###############............################......###########.......######................######....................#####........#######
##............#################............##############.......############......#######................####....................#####.........#######
##...........###################............#############......##############.....########................##....................#####..........#######
##..........######################.......#....###########.....################...##########................#...................#####...........#######
##.........########################............###########...################################..............#.................#######..........########
##.......#################################.....###############################################................................######..........########
##.......##################################....################################################...............................#######.........########
##.......#######################################################################################..............................#######...#.....########
##........########################################################################################............................#######.........########
##........#################################################..######################################..........................#########.........#######
##........################################################....######################################.........................#########..........######
##........################################################.....####################............######........................#########...........#####
##........################################################.....###################..............######........................#########..........#####
##........##################################################..####################...............######.......................##########.........#####
##........########################################################################................##########..................###########.........####
##........################################.....######...##########################.................###########................############........####
##........########...####################.......####....#############....#########...................#########................#############.......####
##......#.##..........######........###..........###....###..#####........########....................#########.....#..........#############......####
##.....................####......................####..#####..###.........#########....................#########...##...........############......####
##......................##.......................###############..........#########.....................##############..........############......####
##...............................................##############...........########.......................#############..........##########.......#####
##..................#............................#############............########........................#############........########..........#####
##.......................................#.......############.............########........................##############......########...........#####
##......................................###......#########................########........................############################...........#####
##.....................................#####....#########.................#########........................#######..##################............####
##.................................#####################..................##########.......................######.....################............####
##................................###############.....#..................###################................####.......#################.#........####
##.................................#############...................#.....########################...........###.........################.........#####
###................................############...................#......########################...........##...........##############..........#####
####..................................#########...........................#######################............#............############............####
#####..............##....................#######...........................######################............#.............##########.............####
#####.............####........#...........#######..........................#######################.........................##########.............####
#####.....###.....#######....##............#######.........................########..#############...................#.....##########.............####
#####......####....#############............########.......................#######....#############........................###########...###......####
####........###.....#############............########......................#######....#############.........................#################.....####
####........###.....############..............###############.............#########..##############.........................##################....####
####........###.....###########................################..........#########################..........................##################....####
####.......#####...###########.................################..........########################...........................###.###############...####
####......############..#####.................##################..........####################..............................##...#############.....###
####.....############....####................###################..........###################..............................####..#############.....###
#####...#############.....###............#######################..........#################..............................####################......###
#####################.....###............##########...##########..........################..............................####################.......###
#####################.....#######.......##########....#....#####.........#################............................######################......####
######################...########################...........####........###################..........................#######################.....#####
#################################################...........####........########################......................################################
########.........################################..........#####........##########################....................########..######################
##.####...........##########...###################.........#####........#######....################..........#........#######....#####################
##.####............########.....###################.......######......#..#####......###########.......................######.......##########......###
##..###.............######......#######......######......#######.....................#########.......................######..........########.......##
##...##.............#####......#######........######.....#######.....................#########......................######...............####.......##
##....#..............####.....#######..........#####.....#######.....................#########......................######................####......##
##....................####...########...........####.....#######.....................#########.....................#######.................####.....##
##.....................##############............####....#######....................##########....................#########................###......##
##.....................#############.............###############...................#########...................#############................##......##
##......................#####....#...............###############..................########..................################.......................###
###........#.............###............###......##############..................########............########################.....................####
###......##..............###...........###.......##############.........################............##########################...................#####
####....###.............####...........###......###############........################............##########################....................#####
#####..###.............######.........###.......###############.......################........#...##########..###############................#...#####
##########...........#########.......####......################......################.........#############....##############....................#####
#########.............###################.....##################....################.........#############......#############...............#....#####
########...............###################...##########.....#######################..........############........############.............###.....####
#######.................##############################.......##########..#########...........###########..........###########............###......####
######...................##############...###########........#########....########............#########...........#########.............####......####
######....................############.....#########.........#########.....########...........#########..........#######...............#####......####
######.......................#########.....#########.........##########.....########..........########...........######................####.......####
######..........................#####......##########.......############.....#######...........#######..........#######...............####.........###
######............................###......############################.......######...........#######.........#########..............####.........###
######.............................##.....#############################.......#######..........########.......##########..............###..........###
######.............................##.....#####################..#####.........#######........##########....#############.............###..........###
######............................###....#####################....##...........######..........###########################............###...........##
######...................############....###############...##...................####............#####################...###..........####...........##
######..................#############....##############...........................#...............###############........###.........#####..........##
#######................##############....############..............................#..............##############.........####.......#######.........##
#######......................########....###########..........#..........................###.....##############..........#######...###########.....###
#######.......................########..############...................................####.......#############.........##############..##############
########......................#######################................................#####.........############........##############....#############
########......................########################.......##.....................######..........############.....###############.....#############
########...####................########################.....####..............############..........##############..###############......#############
###################............##################################......#.....#############..........#############......############......#############
#####################...........##################################....####################..........############........############....##############
######################..........##########################################################.........############............###########################
######################...........#########################################################.........###########..............##########################
#######################..........#########################################################.........##########................#########################
######################............################################.....####################........#########.................#########################
#####################.............####################........###.......####################.......########..................#########################
##################.................################............##.........###################......########...................########################
#################...............#..###############.............#...........###################.....########....................#######################
#################...................############.............................##################...##########.......###.........#######################
##...###########.....................########.................................#########..################################......#######################
##.....#########......................######...................................#######....################################....########################
##......########......................#####.......................................####....############################################################
##.......#####........................####...................#.....................####..#############################################################
##....................................####....................#....................###################...#############################################
##..................##...............#####....................########.............##############.........#######...##################################
##.................####.#...........######.......#.#...........########............#############...........#######.###################################
##..................####...........#######........###...........#######........#..######...................###########################################
##...................##...........########.......................######...........#####....................###########################################
##...............................##########.......................######..........#####....................#################.#########################
##.#.............................##########.......................#######........#######...................###########################################
#####...#.......................############......................########....###########.................##############################.....#########
#########......................############......................#########################................#############################.......########
##...#####......................###########.....................###########################...............###.......##################.........#######
##....####..........####.........##########...................#..###########################..............##.........#######....................######
##.....###......##########.......#########..........................#########################.............##..........#####......................#####
##.....###.....############......#######.............................#########################...........###...........####......................#####
##.....###....###############....#####................................#######################...........###............#####...........#####.....#####
##.....###...#################..#####........######...................#######################..........####............#######........#######....#####
##.....#############...#############........#######...................#######################........######.............##########...#################
##....#############.....###########.........########..................########################......#######..............#############################
##...#############......##########.........##########................######################################...............############################
##..#############........#########.....#..############..............########################################.................#########################
##.############..........#######........###############............#########################################..................##########.......#######
##########...#...........######........################............########################################....................########.........######
#########................#####.........#################...........######################################.......................######...........#####
#########................####..........##################...........##############################..............................#####............#####
########.................####..........####################..........############################...............................#####............#####
########.................####...........#####################.........##########################................................######..#........#####
##.......................####...........####################.......#############################................................#########.........####
##.......................####...........####################.......#############################....................##..........##########.........###
##...............#.......###....#........###################.......##############################...................##..........###########.........##
##...............##.............##.......###################.......###############################..............................#########...........##
##................#.............####......##################.......################################.............................########...#........##
##...............#...............####.....###########....##........############...##########################....................########..####.....###
##................................####.....########................###########......#########################....................###############..####
##.................................###.......###....................#########.......#################.....####....................####################
##.................................###..............................#########.......################.......######.................####################
##..................................##..............................##########......###############.........######...............#####################
##..................................###....................................###......###############..........######.............######################
##.................................#####....................................###.....###############..........######............#######################
##...........................################................###............####...############.###...........######...........#######################
##...........................##################.............#####...........#######################...........#######.........########################
##...........................###################......#.....######.........########################...........########........########################
###.......#####.............#####################....###...########.......###########################.........########........########################
###......#############.....#######################..#####################################################....##########.......########################
###.....##################################################################################################################...#########################
####...###############################################################################################################################################
######################################################################################################################################################
######################################################################################################################################################
######################################################################################################################################################
