###########################################################################
###########################################################################
#############..................################.....####....###############
#######....###..................#################...#####..################
##.###......##..................#########....##############################
##.##.......##...................#######......#############################
##...........#...................######........#.....#.....################
##.#........#....................#####.....................################
###........#.....................###.....................##################
###.............#........................................##################
##.......................................................##################
##......................................#.................#################
##......................................##................#########..###.##
##.##...................................##................#########..###.##
####....................................##.................################
####................#...................###................###..###########
####...............##...................####...............###..###########
####..............###..................#######.............################
##................####................#########............################
###................###...............###########....#......################
##...................#.#............#############.........#################
##..............................###.################.......################
##.......................................###########............###########
##..............................................................###########
##...............................................................##########
##................................................................#########
##..............#..................................#...............########
##..............##...............................####..............########
##.............####......................#.......####................######
##.............####....................##.........#####..............######
##.............####....................##...........####.............######
##.............#####...................###...........................######
##..............##.................#..####.........................########
##......................................##........................#########
##...............................................................##########
##......#..........................................................########
########............................................................#######
#########...........................................................#######
##.#######..........................................................#######
##.########.....................................#...................#######
###########.....................................#...................#######
##########.................#.........................####...........###..##
##########................##.........................#####.........####..##
#########.................##........................######........#########
######...................###........................#######......##########
######...................###........................#######################
######...................###..........#.............#######################
######....................###........#..............########..#############
#######...................####.........................#####..#############
########..................#####............................################
########..................#####..............#.............################
########..................######....................#......################
#########..................#####...........................################
#########...................####..........................#################
######........................###........................########..########
##.#...........................#.........................########..########
##.......................................................##################
##.......................................................##################
##.......................................................##################
##...........................................................##############
##............................................................#############
##.............................................................############
##........................................................#....####..######
####......................................................#########..######
#####.....................................................#################
######....................................................#################
#######...................................................#################
#########.............#...................................#################
#############.........###...........................#######################
###############......####........................#..#######################
##.######################......#..............#############################
##.##############################........##################################
##.########################################################################
###########################################################################
###########################################################################
