###########################################################################
###########################################################################
##..########.........##########################..............##...#########
##..######.........#......#######################...........###############
#####......................######################...........###############
#####......................######################...........###############
####.........................#.....####.....####............###############
####........................................................###############
##.#.......................................#................###############
##.........................................................################
##................##.....................................##################
##................##....................................###################
##.................##...................................###################
##.....................................................############..######
##......................................................###########..######
####...#..................................##.............##################
####....#........#......................#####.............#################
####...###......###...................########............#################
####...###.......###..................#########...........#################
####...###........##.................#..########..........######..#########
####..####.........##...............##..#########.........######..#####..##
##########.........................##############.........#############..##
##..######..........................#####....####.........#################
##...####............................####....#####.........####..##########
##....###............................###.....##..#..........###...#########
##.....#.............................###.....##..#..........###....########
##...................................###......#####..........#......#######
##....................................##......#####.................#######
##.....................................#......#####.................#######
##............................................###...................#######
##...................#..............................................#######
##.................................................................########
##...................................................#............#########
##................................................................#########
##................................................................#########
##...............................#................................#########
##................................................................#########
##................................................................#########
##.#.........................###...................................########
##.##.................#.########...................................########
######.................########...........................#........########
########...............########.........................###........########
########...............#######.......................######........########
########...............######.......................#######.......#########
########...............#####.........#.............#########.....##########
########...............#####....................#.#########################
##########...#.........#####.....................##########################
#########.#.............####....#.................##########..#############
########.................########........#.........#########..#############
#######...................########.................###..###################
#######....................#######..................##...##################
#######....................#####......................#...#################
#######....................#####.......................#..#################
#######.....................######......................###################
#########..............#......#####....##...............##########..#######
##.#######.....................##......##...............##########..#######
##.######................................#..............###################
##......................................................###################
##.............................#..............................#############
###............................................................############
####.......................##..................................############
####......................###..................................############
#####.....................###..................................#####..#####
########.................###................................########..#####
#########...............###.................................###############
##.#######.............###.................................################
##..######.............###...........................###...################
##..##########........####...........................######################
##..###########.....######...........................######################
##..#####..####....########.........................#######################
##..#####..################.....#..................########################
##.######..#########################....#.........#########################
#########..################################################################
###########################################################################
###########################################################################
