###########################################################################
###########################################################################
######............##########.......#############...................########
######.................######.....#############....................########
##.####................########################....................########
##.#####............##########################.....................########
##...########.......#########################......................########
##.......####.......#######....##############.........#............########
##........###.......#######.....#############......###.............########
##..........#..........#####....############.....#####.............########
##.....................#####...##########........############......########
##.....................####....##########........#############....#########
##....................###........########..............####################
##.....................##........########..............####################
##............##.......##.........#####.................###################
##...........####......##..#.......##.....####..........###################
##..........#####.....#.#####.............####...........##################
##.........######........#####............##.............##################
##..........####...........###............#...............#################
##...........##..............#..#........##...............#################
##...........#..........................#.#.............################.##
##......................................................################.##
########...............................................####################
#########.........................................#########################
#######...........................................#########################
##......................................................###################
##......................................#................######.......#####
##..........#..........................###................####.........####
##.....................................#####...............#...........####
##....................................#######..........................####
##...................................###...##..........................####
##...##.............#...............###.....#..........................####
##....##............................##.................................####
##....#........###..................#..................................####
##.............#####...................................................####
##.............######..................................................####
##...............###......................................#............####
##..................................................#########.........#####
##...................................................#######..........#####
##......................................................###..........######
##.......................................................#..........#######
##.........#.............................#.#.......................########
##.......###...........................................###........#########
####.....####.....................................................#########
####.....##########..................................#............#########
#####....###########..............................................#########
#####....############.............................................#########
#####...############...............................................########
#####..#############..........#####................................########
##.###########....#...........####.................................########
##..#########......................................................########
##..########............................................###........########
##.#########............................................##.........########
######..####......................................................#########
######..####.......................................................########
##.#########.......................................................########
##...#######.............................#..........................#######
##.....####.........................................................#######
##.......#..........................................................#######
##....................................#.......................#.....#######
##..................................##.......................##.....#######
##..................................##......................####...########
##..................................##.......................##############
##..................................##..........................###########
##..................................##...........................##########
##...........####.#.................###..........................##########
##.........######....................###.........................##########
##........#######....................####.......#................##########
##........#######.....###............#################...........##########
##.......########....#####...........###################........###########
##......##########..#######.........#####################......############
##.....######################......########################################
###########################################################################
###########################################################################
###########################################################################
