###########################################################################
###########################################################################
#####..................#########################....................#######
#####..................#########################....................#######
####...................##########################..................########
##.....................###################..#####.................#########
##.....................###################..#####................##########
##......#..............##########################...............###########
##..............###....##########################..............############
##...###.......###....###########################..............############
##...####......##...##....###.......######....###.............#############
##....###.....##...........#...................#.............##############
##....###....##.................................#...........###############
##.....###......................................##.........###########...##
##.....####.....................................##.........###########...##
##......####.#........###.................................############...##
##.......####..........###................................############...##
###....................###...............................##################
##......................##...............................##################
##......................................................###################
####..............................................###..####################
#######......................#............#.###############################
#######.............#......................################################
##..##.......................................###########............#######
##..................##.......................###########.............######
##.................###........................##########.............######
##................#####.......................##########.............######
##................######........................########.............######
##.................######..........................#####.............######
##..................#######.......#.........#........................######
##...................########........................................######
##...........#.........#######.......................................######
##...................................................................######
##..................................................................#######
##..................................#...............................#######
##...................................##.............................#######
##............................................................##....#######
##............................................................###...#######
##.....................................................#.....########..####
##....................................................##......#######..####
##...###.......................................................############
##.######.......#..............................................############
#########.......#..............................................############
#########........#.............................................############
#########.........................................................#########
#########.........................##########......................#########
#########.........................##########......................#########
##########........................#####...........##..............#########
##########..................#.########............###.............#########
##########.....................#####.............####.......#.....#########
##########........................................####....#################
###############....................................###...##################
################....................................#######################
##..##############...................................########.....#########
##..###..##########...................................#######.......#######
##..###..##......#........................#####........#######......#######
##..#######..............................#######.......########.....#######
##..#######...............................######............####....#######
##....######..................................###............##############
##.....####.......................####........###.............#############
##.....###.........................###.........###............#############
##....###............................#..........#.............#############
##..####......................................................#############
##..###.......................................................#############
##..###.......................................................#############
##...#####....................................................#############
##...#######...............................#.................##############
##...#######..............#..............###............###################
##....#######...###.....####..........######..........#####################
##....######################.......##########........######################
##....######################.....#############......#######################
##...#######################....###########################################
###########################################################################
###########################################################################
###########################################################################
