###########################################################################
###########################################################################
##.####.....##........########................##........................###
##.###.....###.....###########...............####........................##
##.###....#####...############...............####........................##
######....####################..............####................#........##
#####....#####################..............####................###......##
####....##########.........................#####...............######...###
####.......................................#####.................##########
####.............................#.........######.....##..........#########
###.............................###..............########...........#######
###............................####..............#######..............#####
###......#....................######..............######...............####
###..........................########..##.........######................###
###..........................#############........######................###
##...........................#############........#####.................###
###..........................##############.......#####.................###
##..........................###############......#####..................###
##..........................####....#####......#######..................###
###.........................###......###......#######...................###
####.............#.........###................#######...................###
####.........##.###.......###.................#######....................##
####........########.....###.................#######.....................##
####.......#########..#...#.................#######......................##
####.......#########.........................#####.......................##
####.......##########........................#####......................###
#####......##########........................#####.....................####
######....############.......................######...................#####
######################.......................#######................#######
##.###################.......................########..............########
##....###############........................########.............#########
##......#############..........................######.............#########
##...........#######..............................###.............###.#####
##............#####......###........................#.............#########
#####.........####.......####.....................................#########
#####........####........####......................................########
######......#####........####.................#....................########
##.###......####........####.......................................########
##.....................#####........................................#######
##.....................#####...........................##...........#######
##......................###..........####.............###...........##.####
##..................#....##.........#######............##...........#######
##..................#.....#.......#############..........#..........#######
##..#............................##############....................########
##..............................################..................#########
##......................##......#################................##########
##.....................#........##################.......................##
##.............................###################..............#........##
##...........................#####################.............#........###
##.........##................#########.###########............##.........##
##........####..................##################.......................##
##........###.....................###############........................##
##........###.....................###############........................##
##.........#......................##############........................###
##...................#........#..###############..................#########
##..##.........................#################...................########
#########......................#########..######....................#######
##########.....................########....#####.......................####
###########...................########.....#####.......................####
###########..................#########.....######..................########
##########..................##########....##########...............########
######.....................##########....###########...............########
#####......................##########......########.................#######
#####......................#########................................#######
#####.........#...........##########..........................###....######
#####.......###..........###########......................#####......######
#####......###.........#############......................####.......######
######....####........##############..........##..........###........######
#####....#####.......###############..........#####.......##.........######
##.......######...##################.........#########....##.........######
##.......###########..###############........##########..###........#######
##......###########....###############........###############......########
##.....############....#######################################....#########
###########################################################################
###########################################################################
