###########################################################################
###########################################################################
##.................................#.............##########################
##...........#...................................##########################
##.........####..................................##########################
##..........####...............#................###########################
##...........####....#..........................###########################
##............##................................###########################
##........................#...........#.........####...####################
##..................................####........###.....###################
##.................................#####.......###.......##################
##...####.#........................#####.......##........##################
##..######.................#........####......#..........##################
##.######............................###.........#........#################
###......................#............###.................#################
##...............#.....................###..................###############
##.................#.....................#...................##############
##............................................................#############
##.......#....................................................#############
##............................................................#############
##...........................................................##############
##...........................................................######...#####
##................................................##.........####......####
##....##...............#.........................###.........#..........###
#########..............#........................####....................###
#########........................................###....................###
#########.............##................##.............................####
#########.............##........................#......................####
####..####............##..............................................#####
###....##............##...............................................#####
###..................#....#...........................................#####
###................##....................................#...........######
###................##....#...........#.....#............##..........#######
##.................#....###...........#######...........##...........######
##..#...............#...###...........#####.............##...........######
##......................##...........####..............###...........######
##......................##..........####...............###...........######
##......................##.........####........#.......###............#####
##.......#.............###.........####................###............#####
##......###...........#####.......#####...............####.............####
#############........######.......####................####..............###
##############.......######......#####...........................#......###
#################....#######.......###................#..................##
####...##########....#######.................#...........................##
###.......####.......#######.............................................##
####..................#####..............................................##
#####.................####..........................................#######
######................###......................#..................#########
#####...................#............................#..........###########
#####................................................##........############
####................................................####.....##############
####...................##...........................#####...###############
####...................###.........................########################
####...................###...........................######################
####...........#.......####...........................#####################
####.............#....#####...........................#####################
####....###.....############.........................#....#################
####....####....#############......................#......#################
#####..#####....##############............................#################
############....########.....##..........................##############.###
##.##########..#######.........#.........................##################
##..#################..........##.....#..................##################
##..#####.##########............######....................#################
##..################............#######......##...........#################
##..################.............###........###............################
##.###############.##...........#.........######...........################
#####################......................######..........################
#####################.........................####.........################
######################.........................####........####...#########
#####################.........................######......####.....########
#####################.....................#..################......########
####################..................#######################......########
####################.....#...........########################......########
###########################################################################
###########################################################################
