###########################################################################
###########################################################################
##.....#.........................########.........#########################
##......##......................##########.......##########################
##.....####................################......##########################
##.....####...............#########......#......################..#########
##.......#.............###########.............#################...########
##.....................#########..............####..############.....######
##.....................#######.................##...#############......####
##.......................####........................############.......###
##...............#........###........................#############.......##
##...........##...........###.........................############.......##
##........................##.............###...........############......##
##........................................###..........############......##
##.#.......................................#...........#############....###
######..................................................###################
######..................................................###################
##...##.................................................###################
##.......................................................##################
##........................................................#################
##.........................................................###########...##
##...........................................................#######.....##
##.............................................................####......##
##..........................................#............................##
##............#####..............................#.......................##
##...........#####.......................................................##
##............###................................##......................##
##............###.............###................###.....................##
##............##...............########..........####..##................##
##.....................#.......########..........#########...............##
##...................####.......#######..........##########.............###
##..................######......########...#.....#########...........######
##..................######......#############....########...........#######
##.............##..#######......#############....########.........#########
##...........##############......############....########........##########
##..........##############.......############....########......############
##......##################.......############.....#######.......###########
##....###########..#######.........##########......######.......###########
##.....#########....######..........#...............#####........##########
##......#######.....######..........................#####.........#########
##......#######......####............................####.........#########
##......########......###............................####.........#...#####
##.....########........#..............................###..............####
##....########.........................................................####
##....#######..........................................................####
##...#######..........................................................#####
##...######........................................................########
##...#####........................................................#########
##....####.......................................................##########
##......#...#.###...............................................###########
###...........######...........#..................................###.#####
#####.........##########......###..................................########
######.........##########....###............................#.......#######
#######..........########....###......................##.............######
########.........########....###.................########.............#####
########.........########.....###..............#########..............#####
######...........########......#..............##########..............#####
###.............#########...........#.........####....##.............######
##.............##########...........#..........##............##############
##............##########.......................##..........################
##...........##########........................##..........################
##.........###########.................#......###..........################
##.......############...................#.....###..........################
##........##########........#................#####.........################
##.........#########........####.......##....####..........################
##..........########........######.....###..####...........################
##..........########.........#######..##########..........#################
##..........########..............#############...........#################
##....#....#########...............###########...........##################
##...###..##########...............###########..........#########..########
##..############..###..............##########..........#########...########
###############....###............####..#####.........##########..#########
###############....####.....#....############....##########################
###########################################################################
###########################################################################
