###########################################################################
###########################################################################
##....######...#######...............#..####..#######......####..........##
##....######....######...#...............#############......##..........###
##...#######.....######.###..............##############.................###
##..#########.....########................###########..................####
##############......#####..................#########..................#####
###############......##.....................########.................######
###############.................................#####...............#######
########...........................................................########
##...##............................................................########
##.....................................................#...........########
##...........##......................................##...........#..######
##...........##..............###########............####.........#....#####
##..#........##..............##########............####................####
##.....................#......#########...........####.................####
##................#..###.......########...........####.................####
##..................#####......########..........#####.................####
##..................######.....########..........#####.................####
##.................########...#########...........####................#####
##..................####################..........####................#####
##..................####################..........####...............######
##..................####################...........###..............#######
##....#..............#####.#####...####............##.......###############
##..........................###.....###............##.....#################
##...........................#.......#.............##.....#################
##.................................................##....##################
##.................................................###....###....##########
##..................................................#.............#########
##.#...............................###................................#####
#####..............................#####.....#.........................####
#####...............................##..................................###
#####....###....#.......####............................................###
####.....####........########...........................................###
###......####.......##########.......................#..................###
###......####......############.........#...........###.................###
###......####.....###############..................#.###................###
###...............################.....................#...............####
###...............#################.........................#.........#####
###...............###################................................######
##.................####################...###.......................#######
##..................############....###########....................########
##..................###..######......############..........#.......########
##.........#..#.....##....#####.......###########..................########
##..................##....####.........##########....................######
##..................###..#####.........##########......................####
##..#...............#########...........##########........#.............###
##.###.............##########............############....................##
#######............#######................############.....#.............##
##.#####...........######.................####.....##.............#.....###
##.######...........####..................###..........................####
##..######...........###.................#####.......................######
##....#...............####.......##.....########....................#######
##.....................####.#....###...##########.................#########
##..............................####...###########...............##########
##.............................######.#############............############
####...........................#####################...........############
#####.........................######################...........############
#######......................#############...######.......#.....###########
#######.....................#############......####.............###########
#######..................###############........................###########
######...................###############........................###########
#####....................###############.........................##########
#####..........#.........###############.........................##########
#####....................###############.........................##########
#####....................###############..........................##.....##
#####....................##############..................................##
######...................#############..............#....................##
#######..................#############.............####..................##
########.................############.............#####..................##
#########................############.......#....######....###...........##
###########..............####..######......###..######.....######........##
###############.........####...######......###########....########......###
###########################################################################
###########################################################################
