###########################################################################
###########################################################################
##...#########..........#.......##......####............#.####........#####
##....##.#####..................##......###...........................#####
##....#######...................###....####...........................#####
##....#######...................###########............................####
##....#######...................############...........................####
##....#######...................#############..................#.......####
##....#######....................############.........................#####
##....#######.....................###########...........................###
##....######......................##########.............................##
##....####........................##.#####.....................#.........##
##....###......................###....###................................##
##....###.............############....##................................###
##.....##..............##########......................................####
##.....###.............##########.....................................#####
##......#..........#...##########.....................................#####
##......#...............#########....................................######
##......................##########...........................##.......#####
##......................###########...........................##.......####
##......................###########...........................##.......####
##.##....................##########...........................###......####
############................########.....................#....###.....#####
#############........#.......########..................###....###....######
##############................#######................####......###...######
####################..........######................#####......#......#####
############..#########.......####.................#####...............####
############...#########..........................#####................####
############....##########.......................#####.................####
############.....#########...........#.............#...................####
############......#########...........#.................................###
#############.....#########..........####...............................###
#############.....##########.........###...............................####
##############....##########........###...............#...............#####
#############.........#####.........##................#.............#######
#############..........###.........##................##.............#######
############............#.........###...............####............#######
####.............................###.................####...........#######
##.............................#####.................####..........########
##.............................#####......##...........##..........########
##...........#................######.....####......................########
##..................##.......########..######......................####.###
##..................###.....#################......................########
##......#...........###....##################.....................#########
##.................#####..####################.....................########
##..................############################...................########
##..................###########################.....................#######
###..................######......##############......................######
####...................###........#######.#####.......................#####
#####...................#..........#####...####.......................#####
########...........................######..####........................####
##....###..........................#############.....##.................###
##.....#..........................#####################.................###
##...............................######################.................###
##..............................########################................###
##..............................#########################...............###
#####.............#####.........##.....##################..........#...####
########..........#########..............#####.....#######...........######
#########........###########..............###.......######............#####
#######.........############...............#...........####...........#####
######..........############.......#....................#####.........#####
#####...........#############............................###..........#####
#####..............###########...........................###..........#####
#####....#..........###########.........................####..........#####
#####.....#.........##########........#................####...........#####
####.....####.......#########........###..............####............#####
####.....####################........####............#####............#####
####....##############..............######...........###..#...........#####
####....#############...............######..........####..............#####
####....#############...............#######.........#####.............#####
####....#############.............#########........#######............#####
####....##############...........###########......#############........####
####....###############........##################################......####
###########################################################################
###########################################################################
