###########################################################################
###########################################################################
##########################################........##################....###
######..##############...################.........##################....###
##.##....############.....###############..........#################....###
#####....############.....###############............###############.....##
######..##############...################.............#############......##
########################################..............#############......##
#######################################...............#############.....###
#################################..###........###....###.###########..#####
##..############################.............#####..####.##################
##..#######################..##.............###############################
##..######################................#################################
##..#####################........####....##################################
##.######################.......######..###################################
##########################......###########################################
###########################.....###########################################
############################....###########################################
############################...############################################
############################..####################################..#######
###########################...#############....##################....######
##########################.....###########......###############.......#####
##########################.....###########......##############.........####
##########################.....###########......#############...........###
###########################...############......#####..######............##
##########################################.......###....#####............##
#######################################...###...........#####............##
######################################....####..........######.....###..###
######################################....#####.........#######...#########
#####################################.....######........###################
#####################..##############....########........##################
###################.....#############....#########.......##################
##############..........##############..#############...###################
########..###...........##########################################...######
#######................##########################################.....#####
######.................#######################################.........####
######.................######################################..........####
#######................######################################.........#####
#######................######################################......########
########........####..########################################....#########
#########......###############################################....#########
##########.....###############################################...##########
##########.....############..################################....##########
#########......###..######....##############################.....##########
########.......##....####........###########################.....##########
#######........##....####.........###########################...###########
#######.......###.....####........#########################################
########.....####......####......##########################################
########....######.....#####....###########################################
#########..########....####################################################
####################....###################################################
#####################....######....########################################
#####################....#####......#######..##############################
######################..######......######....#############################
###############################....#######.....############################
##########################################.......##########################
###########################################.......#########################
##############################################....#########################
###############################################..##########################
#######################################################################..##
###########################################################...########...##
##########################################################.....#######...##
##########################################################.....######....##
##################################...#####################....######....###
#################################.....####################....######....###
#################################.....####################....######....###
##################################...#####################.....######..####
#########################################################......############
#########################################..##############......############
########################################....#############.....###...#######
########################################....#############....###.....######
########################################....##############..####.....######
#########################################..######################...#######
###########################################################################
###########################################################################
