###########################################################################
###########################################################################
#######........###.........########......#..##.....##.............#########
######.........###...........#######...#######.....###............#########
###............##.............################.....####...........###...###
##..............#.............###############......###...................##
##..................#.........###############......###...................##
##............................##############.......###..................###
##.............................#############.......###.................####
##.......##.....................###..#######.......###..............#..####
##....#######....................#....######.......###.................####
##.##########...........#.............######......###..#...............####
##.##########..........####............#####......##...................####
##..########.........########......#....####......#....................####
##..########........##########............#...........................#####
##...#######.......############......................................######
##...######.........############.....................................######
##...######..........############.............................#.....#######
##...######..........#.......#####............................##...########
##...######..................######..........................##############
##...######..................#####............................#############
##...#######.................#####.......#....................#############
##...#########...............#####......#...........................#######
##...###########..............####...................................######
##...###########..............####.................#..................#####
##..#############..............##.................###.................#####
#################..............##.................###.................#####
#################..............#.....#.............###................#####
#######.......###.............##.....##....#........##................#####
######.........##...........####..#..##................................####
######.........##..........###......####...............................####
#######........#..........###........#####.............................####
########......##........#####.........#####...........................#####
#########....###.......#######.............#.........................######
##########..####......########......................................#######
################......########.....................................########
######....#######...#.#########...................................#########
#####......######.......########.................#.................########
####........######.......########..................................########
###..........######.......########.......###......#....#...........########
###...........######......#....####.....#####......#......#........########
##............#######...........#############.......................#######
##............##..####...........#############......................#######
##............#....####..........#############........................#####
##...........#......####........###############........................####
##..................#####......###############..........................###
##...........#.......########################............................##
##...................########################....##......................##
###...................########################.#####......#.............###
#####.................#####........################......##....#........###
####...................###..........###############.....###.............###
###.....................#............#############......#...............###
##.....#............................#############.......................###
##.....###........................###############.......#..............####
##.....#####......................################.....##..............####
##....#######........######.......################.....##.............#####
##..#########.......########......####.....#######.....##.............#####
#############......##########....####.......####.......##.............#####
########............##########..####.........#.........##.............#####
##..###..............##############....................###...........######
##..###...............###########.....#................###...........######
##..####..............##########.......................####..........######
##..#####.............#########........................####..........######
##..#######...........########.........................#####..........#####
##...#######.........#########..........................####..........#####
##....#######........#########..........................#####........######
##.....#######......##########........####...............####........######
##.......#####################........####...............#####......#######
##.......#############....####.......#####..............#######....########
##.......#############.....####.....#######...##....#######################
##......###############.....###...##############...########################
####...#################....####.###############...########################
#########################..#####################..#########################
###########################################################################
###########################################################################
