###########################################################################
###########################################################################
##......#...###..............#..#######.................###################
##..................................##.................########..#######.##
##...................................#..............###########..#######.##
##.................................................########################
##.................................................########################
##.................................................###########..###########
##..................................................##########..###########
##....................................................#####################
##.......................#............................#####################
##...................................................############..########
##..............#...................#.#.............#.###########..########
##.......##..............................................##################
##........................................................#################
##........................................................#################
##...#....................................................#################
##.........................................##.............#################
##.........................................##.............#################
##.........................................###............#################
##........................................................#################
##.........................................................################
##.........................................................################
##............................................................##########.##
##............................................#................#########.##
##..............................................#................##########
##...............................................#...................######
##..............................................###...................#####
##..#...........................................###...................#####
##...........#..................................###...................#####
##.....#...####.................................###...................#####
##.........####.................................###........##.........#####
##..........###...................................#.........###.......#####
##..........##..............#.#...##..........................#.......#####
##..........##.......................................................######
##..........##......................................................#######
##..........##......................................................#######
##..........##.....................................................########
##..#.......###.......#............................................########
##..##......###.......#............................................########
##.###......##.........##..........................................########
######.....###.........####..........................#.............########
#####.....###..........####.........................####...........########
#####.....##...........####.........................####...........########
####.......#...........#####...............##......................########
####....................####..............#.#....................##########
####.....................####..................................############
#####....................###...................................############
######...................###..................................#############
######...................###.................................##############
#######..........##......##..................................##############
#######........#####......#.................................###############
######........#######......................................################
######.........####.......................................#################
##.##.....................###.............................#################
##.##...................#####.............................#################
##.##...................#####.............................#################
##......................####...................#...........################
##.#.....................#..................###........#....###############
##.............#......................#....###...............##############
##...........#####..........................##..#.....###....##############
##.......##.#######.........................######....########..###########
##......##.......#.............................#####.....#####..###########
#########.......................................####......#################
#########........................................###......#################
###########.......................................###.....#################
############.........................#.............####..##################
##############.....................................########################
##.############......................##.............#######################
##.#############....................###.............#######################
#######################...........######........###########################
########################.........#########..###############################
#########################......############################################
###########################################################################
###########################################################################
