###########################################################################
###########################################################################
#######.......................##############..........................#####
########.....................###############.........................######
#######................#####################........................#######
#######................#####################.......................########
#####..................####################......................##########
####...................#####..#############....................############
####...................#####..#############....................############
##.#....................################.......................############
##..#.#####.............###############........................############
##...#######..............###....#####.........................############
##...#######...............#......####....................##...############
##...#######.......................####...........#.......#################
##...#######.......................#####.........###......#################
##...#######............#..........####..........###......#############..##
##.#########.......................###..........###.......#############..##
##.####.............................#..........###........#################
##.##..............................#...........#..........#################
##.##.....................................................#################
##.##...........................##........................#################
#####...........................#.........................#################
######...................................................##################
######...........................................############.......#######
######...........................................###########.........######
#####............#..............................##########...........######
#####...........................................########.............######
##.#................####..........#............########..............######
##..#...............####.........#..............#######..............######
##.................######........##..............#####...............######
##..................#####........#................###................######
##..................#####...........................................#######
##..................####.............................................######
##....................................................................#####
##....................................................................#####
##.................................#..................................#####
##......#.............................................................#####
##...................#................................................#####
##....................................................................#####
##................................................................#########
###............................................................############
##########.....................................................############
###########..............#...........................#.........############
############...............................##.......##.........#...########
######..######...............................#......##.............########
######..#####................................#.......##............########
############...........................................#...........########
############..............................#........................########
############....................###................................########
###########......................###...............................########
###########...................................................#############
##.#######...............................................##################
##..#####....................##........................####################
##..#####.............#.......##......................########...##########
##..####...............#..............................########....#########
##..###...............#.........#......................#######.....########
##..###................#.................####..........#######.....##..####
##..#######........................#......####.........#######.....##..####
##..#######........................#.......###.........########....########
##..##..###........................##.......#...........###################
##.###..##................#........##...................###..##############
##..#####..........................##...................##....#############
##...###............................#.........................#############
###..###......................................................#############
########.................#....................................#############
##..####...##............####..............................################
##....#########..........###..............................#################
##.....#########.........###...........#.................##################
##......###########......###.........####...............###################
##......####################........#######..........######################
##....######################......#########################################
##..#######################################################################
##.########################################################################
###########################################################################
###########################################################################
