######################################################################################################################################################
######################################################################################################################################################
#######.....##############...##..........###############..................#####################################################...########.....#######
#######....####################..........###############............##...#######################################################.#########.....#######
#######....####################.........###############.............###..#####################################################...########.......######
#######....####################........###############.............#######################################################.......########.......######
#######....####################.......###############..............###################################################............######........######
#######....#####################.....################.....#........###################################################.............#####........######
########..#######################...#################....###.......################################....###############..............####........######
######################################################..#####......###############################......#####.########..............####........######
##....#######################################################......##############################........###...######................###........######
##.....######################################################......##############################........###...######.................##.......#######
##.....#######################################################....###############################........###...######..................##.....########
##.....##########################################################################################.......#####..######...................##############
###...###########################################################################################......######..#####.........#..........##############
##################################################################################################....#######..#####.......###..........##############
#############################################################################################################..####.......####...........#############
##...#############################################################################################################........#####..........#############
##....###############################################################################....#########################........######............##########
##....##############################################################################......#....##################.........#########..........#########
##....##############################################################################.............################.........#########...........########
##....#####################################################..#######################..............###############.........#########............#######
##....###############################......###############....#####..###############...............##############........##########............#######
##....########.....###########..............##############....####....##############................#######.#####........###########..........########
##....#######.......#########................##############..####......##############................#####..#####.........##########.........#########
##...########........#######..................##################........#############................######.#####.........###########.......##########
##.....######..........#####..................################......#....############................############..........###########.....###########
##......######...........#....................##############.............############.................###########...........##########################
##........######..............................############..............##############................###########...........###############.......####
##.........######.............................##########...........#...####################............###########..........###########............###
###.........#######...........................#########...........###########################..........############....#....##########.............###
####.........#######.....................##..#########............#############################.........#################..##########..............###
#####.........########.................##############.............###############################.............######################...............###
######............#####................##############..............###############################.............####################...............####
######.............####................##############...............##############################...............##################...............####
######..............###................##########....................#############################................##################..............####
#######..............###...#...........#########......................############################.................##################............#####
######................######...........#########.......................###########################.................###################...........#####
######................#####............#########........................##########################................########################.......#####
#####................#####.............#########........................########################.................#########################......######
#####...............#####.............##########........................#######################.................##########################.....#######
######.............#####.....##........#########...........##...........######################.................###########################....########
#########.........######......#........##########..........##..........######################.................#############################..#########
###########......#######.....#.........##########.........###.........#######################................######.........##########################
##############..#########...............##########.......####.......##########################...........#######.............#########################
##########################..............###########.....#####.......###########################..........######..............#########################
###########################.............######################......##############################......######...............#########################
###########################................####################.....#########################################................#########################
###########################.................####################.....#######################################................##########################
###########################.................#####################.....#####################################................###########################
##########################.................#######################.....##################....#############................############################
##########################................########################......################......###########................#############################
#########################...............##########################......################......##########..............################################
###############...#######.............###############...##########......#################....##########........#######################################
##############.....#####............################.....#########.......#############################........########################################
##############......###...........#################......#########.......############################.........########################################
##############......##..........#################.......###########.......##########################.........#############.......#####################
##############.................####....................############........########################..........###########..........####################
##############.................###....................##############..........##################.............##########...........####################
##############................###....................################..........################..............##########...........####################
###############..............###....................##################.........##############...............############...........###################
################............####................#######################........#############...............############............###################
##################..........####..............##########################......#############...............#############............###################
##############..##.........######............#############################################............#################.....................##########
#############..............#######..........##############################################...........###################.....................#########
############..............##########.......###############################################..........####################.....................#########
######..###...............##############..################################################.........####################.....................##########
#####....##..............##################################################################......######################....................###########
#####....##............###################################################################################...##########...................############
######..####...........##################################################################################.....########...................#############
################........##########################...####################################################.....########..................#####..#######
################.........########################.....##############################......################....#######..................#####....######
#################........########################......############################........##########################.................######....######
#################........########################.......###########################........##########################................######.....######
################......#..#########################.......##########################........###########################..........##########......######
################.........###......####..###########......####################.#####........############################.......#########.........######
#############.............#.........#....###########....####################...####........###########################################..........######
############.............................#################################.....####........##########################################..........#######
############.............................##############################........####........#########################################...........#######
####.....####............................#########################............#####.......##########################################..........########
##........########...............##......########################..............####.......#########################..###############.........#########
##.........#######.............#####.....#############......####...............#####.....#########################....###############.......##########
##..........######............#######....############........##................###################################....################....############
##...........#####......##############..#############........###.........#.....####################################..#################################
##............#####...###############################.......########....###.....############.......###################################################
##............########################################.....################.....#########...........##################################################
##............#########......##########################...#################.....########.............#################################################
##..#........#########..........###########################################.....#######..............#################################################
######......#########............##########################################....########..............#################################################
#####################.............#########################################...#########..............#################################################
####################..............######################################################............##################################################
####################.............##############.################...######################..........###################################################
###################.............###############################......#####################.........###################################################
###################.............###############################......######################.......####################..##############################
###################.............################....###########......#######################.....####################....#############################
##################..............###############......#....####.......################################################....#############################
##################..............##############............####.......#################################################..##############################
##################.............##############..............###...........#############################################################################
#################..............#############...............#..............############################################################################
##.#############..............##############...............................###########################################################################
##..#########.................###############...............................##########################################################################
##...####....................############.####...............................##..#####################################################################
##...###....................##################.................###...........#....####################################################################
##...###....................#################................#####................################...#################################################
##...###....................###############..................#####...............################.....################################################
##...###...................###############..................#######.............################.......###############################################
##...##..............#.....###############..................########...........############.............##############################################
##..###.............###....###############.................###############################...............#############################################
##..####............####..#################...............###############################................###......###################....#############
##...#####.........#########################..............####################.##########.................#........#################......############
##....#######.....############################.............###############################..........................################......############
##....##############################...######...............###############################..........................###############.....#############
##....#############################.....####...........#.....####################################.....................###############....#############
##....#############################.......#...................####################################..#..................###############..##############
##...##############################....................#......#######################################...................##############################
##...###############################.........................#########################################...................#############################
##...################################.......................###########################################...................############################
##...##############################.......................##############################################...................###########################
##..#############################.....#####...............###############################################...................##########################
######################.#########.....#########.............###############################################..................##########################
#################...############.....###########............#############################################....................#########################
############..###....############...##############...........############################################.......#.............########################
############...##.....#############################...........##########################################.......................########...#....#######
###########.....#.......#############################..........########################################........................#######..........######
##########...............#############################..........#######################################........................#######...........#####
#########.................#############################..........######################################........................#######............####
########...................############################...........####################################.........................#######............####
########...................#############################..........###################################..........................#######............####
##...###...................############################...........##################################...........................########...........####
##........................############################............##################################...........................#########..........####
##........................############################............############....##################..........................###########........#####
##..........................###############.....######..............#########......#################..........................#############.....######
##...........................##########.............#............#....#######.......###############...........................########################
##............................########.................................######.......##############............................########################
##.............................######...................................#####.......##############............................########################
##.............................######...................................#####.......##############...........###..............########################
##........##....................#####............#.......................####.......##############..........######............########################
##..............................#####............#.......................#####.....###############..........#######...........########################
##.........................#...######.................#..................##########################........#########..........########################
##...#.....................###########..................................############################.......##########.........########################
##.........................############...............#................###############################.....###########........########################
##...............#.........################..........####.........#####################################..################.....########################
##...............############################.......#####################################################################....#########################
############....##############################.....########################################################################.##########################
######################################################################################################################################################
######################################################################################################################################################
######################################################################################################################################################
######################################################################################################################################################
######################################################################################################################################################
######################################################################################################################################################
