###########################################################################
###########################################################################
########################..............######..............###########....##
########################.............#######....................#####....##
##...........##########.............########.....................#####...##
##.............#######.............#########........#...............###..##
##...............###..............##########.....#####...............######
##.......#........#................########.......#####...............#####
##......###..........................#####........#######.............#####
############..........................####.........#######............#####
############.........................#####..........######............#####
##.......#........#.................######..........#######...........#####
##.................................#######...........######...........#####
##.........................#.....######...............#####...........#####
##..............#...............######.................####...........#####
###.....................#......######...................###...........#####
##............#.........############..................................#####
##...###...............#############.................................######
##..#######...........#############...........................#.###########
##...#######.........############......###.....................############
##....#######.......#####..#####......#####....................############
###...########....######....###.......#####.....................###########
##.....################.....##.........#####.....................##########
###....###############.....##...........#####.....................#########
##.....###############..................#####.......................#######
##.......##############..................####.......#.................#####
##........#############....................##..........................####
###......##############......................#.......##.................###
#######################.....................#......#####.................##
#################...............#..................#######...............##
##...###########..................................##########.............##
##.......######..................................############............##
##.........##...................................########.#####...........##
##.............................................##########.####...........##
####..........................................##############.............##
#####................................#........#############.........###..##
####...................#......#....#####.......###########.........########
##....................#########.....#####.......#####..###.........########
##...................#########......#####........##................########
##...................########.......#####.................#.......#########
##...................####..........#####...........................########
##................................######...........................########
##..............................########............................#######
##.........####................#########............................#######
##..........####...............##########...........................#######
##..........#####.............###############.......................#######
##..........#####..............################......................######
##...........####...............#################....................######
##.............##................################........####........######
##..............#.................##############.........####........######
##................................#############..........###.........######
##................................#############.........####.........######
##................................##############.........###.........######
##................##.............#################....#...##.........######
##.###...........####...........###################...#...##.........######
########........#####.....#....#####################......##.........######
########........#####.......#########.......########......###........######
#########.......###.........########.........#######.....####........######
########.........#...........######..........#######.....####........######
########.....................#####...........#######....######......#######
#######......................####.............######.....######....########
######.......................###..............##.........##################
#####........................###..........................#################
####.................#......####...........................################
##..................###.....####...........................######.....#####
##.................#####...#####...........................#####.......####
##................##############...........................####........####
##...............###############...........................###.........####
##...............#############.............#......##.......####........####
##...............##########......................####.....######......#####
##....#####.....##########.................##...#################....######
##...####################..................################################
##.######################..........###.....################################
###########################################################################
###########################################################################
