###########################################################################
###########################################################################
##..........#######.........#####.............#...#########################
##..........######..........######...............##########################
##...........####...........######..............###########################
##..........................######...............##########################
##...........................#####...............##########################
##...........................#####..................#######################
##............................####...................######################
##.............................###....................##############..#####
##....................................................#############....####
##....................................................#############....####
##....................................................#############....####
##...........#............................................#########....####
##...............####......................................#########..#####
###..............#####.#....................................###############
###.............#####........................................##############
##...............##..........................................##############
##..............................##...........................#####..#######
##........#....................####.........#...............#####....######
##......##......................####...............#.........####.....#####
##.................................####............#..........###......####
##..................................###............#..........###......####
##...................................##...........##.........####......####
##................................................##........######..###.###
###...............................................##.......################
###...............................................###......################
###...............................................####......###############
####............................####.............######............########
###.............................####..........#########.............#######
###.............................#####......############..............######
##............##................#####.....##############.............######
##..........####...............#######...################............######
##.........######..............###########################.#.........######
##........#######..............###########################..........#######
##.......############............#############...#######............#######
##......###############...............##...###...######............########
##......################....................###..#####.............########
##......###############................##....#########.............########
##......###############......................#########.............########
##.......##############.......................#######..............########
##.......######..#######.......................######.............#########
##.........##.....#######.......................####..............#########
##...#.............#######......................##................###...###
#######............########.......................................###....##
########...........###########...................................####....##
##.....#............####.#######................................#####....##
##.......................######..............##................#######..###
##.......................####...........................#.....#############
##........................##..........................####...##############
###.................................................#######################
###......................#.....................#...########################
##......................###.....................#####..####################
##.#....##...............##....................#####....###################
##.....###...............###....................####....###################
##.....####..............###.....................###....######..###########
##...............................................####..####......##########
##.............####..........####................#########......###########
##.............#######........###................######........############
##............#######.........###.................####........#############
##..........#########.........###.................###........##############
##.........##########.........###.................##.........##############
##........##########..........###..................#........###############
##.......##########...........###......#...................################
##.....###########............###......##.................#################
################.............###......####...#...........###..#############
###############.............####......####......#........##....############
##############.............####.......#####.....##......###....############
##.##########......###...#######.......#####....####...####....############
##.#########.......#########..###......######...###########...#############
############......#########....###....########..###########################
############.....#########.....##############...###########################
#############..###########....###############...###########################
###########################################################################
###########################################################################
