###########################################################################
###########################################################################
##..........#####.................................##############....#######
##.........######.................................##############....#######
##..........######................................##############...########
##.............##................................################.#########
##..............#........................##......##########################
##.....................#...........#######.......##########################
##.....................###........#######........##########################
##....................#####.......#######........##########################
##.....................####.......#######.........#########################
##...#..................####......#######..........##..####################
##.......................####.....#########.......#.....###################
##........................####.....#########.............##################
##.........................##.......########.............##################
##..................................##....###...........###################
##.........................................###.........####################
##..........................................###......######################
##...........................................##......######################
####................##........................#......##########..##########
######............####..............................####...####...#########
#######......#....#####.............................###.....###...#########
#######............#####...........................####.....####.##########
#####..............###............................######...########.....###
#####...................................#.........##############.........##
#####.................................###......#......########...........##
##.#.................................####..............#####.............##
##.#................................#####................##..............##
##.................................######................................##
##................................#######................................##
##.##.................#...........########...............................##
####................#####.........########..............##...............##
##...#.............#####..........#########...........####..........#....##
##................#####...........###############.....#####............####
##.........##....#####.............##############......###...........######
##..#.....###########..............##############......##...........#######
##........##############...........####..#######.......##...........#######
##.......#################.........###....#####.......###...........#######
##.......#################.........###......##........###...........#######
##.......#################..........##................###..........########
##.#.....#################..........##.................##.........#####..##
###......##################.........##.....#............##...##..#####...##
##.......##################..........#..................##...............##
##.......####...####.######....................##.......##...............##
##...............###..#####....................##.......##...............##
##..............#####.#####...................##........##..............###
###............###########....................##........##..............###
###..............########....................##.........##..............###
##...........#....######................................##.............####
##..................####..........##...................###........##..#####
##...................###..............................####........#########
##...................###............................#######......##########
##..................####............................#######........########
##.................#####............................######..........#######
##...............########...........................####............#######
##......#################............................##..................##
##.....###################...................#.......#...................##
##..#######...#############.................#................###.........##
##########.....#################.............................####.......###
##########.....#############.###............................######.....####
##########....#############....##..................#........######....#####
##########################.......#......#......#####........#######..######
########.#################.....................######......################
##########################.......#............######.......################
##########################....................######.......################
##########################....................######.......################
#######################.......................######......#################
####################.........................########....##################
###################.........................##########..###################
###################........................################################
###################...............#########################################
##################.............############################################
###################..........########.#####################################
###########################################################################
###########################################################################
