######################################################################################################################################################
######################################################################################################################################################
###################...####.......#################.....####..............##############.......#######################.............####..............##
##########.########...###...............############...######............##############........######################.............######............##
#####.......######....###................#####################...........###############..........##################.............########...........##
###...........#####...###........###.......####################..........#########.#######..........####.#############...........########..........###
###............#####..##........#####........###################.........##################.............###############..........#######...........###
##....#.........#####...........######........###################........##########...######.............##.....########.........######............###
##...............####...........######..........##################.......#########.....######....................#######.........##########........###
##..............######..........#####...........##################........#######.........##......................#####...........##########........##
##..............######..........####..........####################.................................................................#########.......###
##.............########.........#####........#####################.....................................####.........................########......####
##...........##########....####.#####.......###.....######.#..#######............#...................#######..........#.............#######......#####
##........############....###########.......###.....#######...##########.......####...##............#########.......................######......######
##.......############.....###########...............#######....####################..####..........##########........................###........######
##......#########.........###########..............########.....###################..#####........###########...................................######
##.....##########..........#################......#########......#################...#####.......###########...................................#######
##......########..........##################.....##########.......###############....######.....########..........#...............#............#######
##......#########.........###################....###########......################...######....#######.................####.......##......###..#######
##........#########......####################...############......#################..######....######..................######.....##.....#############
##........############..#######.....#########...############.......########...######..######.#######...................#######...........#############
##.........##################.........#######...############...................#####...############.....................######............###.###.####
##..........################..........######...############.................########...###########...#...................####......................###
##...........################..........####...######.....................############...#########...####..................##.......................###
##............################................#####.#..........##.......#############...######.....#######.....##.................................####
##...........###################...............#######........###......###############..#####......########...####........................#.......####
##...........########....########..............########......#####.....###############..####........##############................................####
##......###..#####.........######...............#######.....#######....##########.###....##..........#############..........##.......#............####
##.....#########....##......#####................######....#########....#########.....................############.........###......###...........####
##.....#######.....####.....#####................######....##########.....######.......................##########..........###......####..........####
##......#####......####......####.................#####....##########.......###..........................#########..................#####.........####
##..................##........##...................####....##########.....................................########..................#####..........###
###.................................................###....#########........................................######..................#####..........###
####................................................###.....########.......##...............................#######...........##....#####..........###
####.................................................###....########......####.....................###.....########..#...########...####...........###
###.............................................#....####...########......#####...................#####....###########.##########...##.............###
##.........................####..........####..###..#####...########......#####...................#####...######.##.#############..................###
##........................#####.........################....#######.......######..................####...##########################................###
##........................#####........#################....######........#######.......####......###...############################...............###
##.........................###........###################....######.......########.....######.....##....##########..#################..............###
#######...............................###################....#######.......########...##########........#########.......#############..............###
########............................###############..#####....#######.......#######...###########......#######...........###########...............###
#########........######............#########.........#####.....######.......######....############.....######.............############............####
##########......########..........########............####......#####........####.....#############....####....................########..........#####
##########......########..........#######..............###.............................#############...####.....................#########........#####
####.#####......#######............#####................##..............................############...###.......................#########.......#####
####..###........#####...............##..................................................##########...........###.................#########......#####
###..............###......................................................................######..............####..................########.....#####
##...............####......................................#####...........................#####...............###..................########.....#####
##..........##########....................................#######..........................#####................#..................##########.....####
##......################.................##..............#######................##..........####.......................###........###########......###
##.....#################................####.............######........###.....####..........##.......................#####.......###########......###
##....##################.................####............####.........######.#######..................................#####.......###########......###
##....##################.................#####............#..........##############...................................#####.......###########.......##
##....#################..................#####.......................#############..........##..............####.......###.........#####.###........##
##....####..###########..................######.......................###########.......#######.......#....######...................####............##
##.............#######...................######..........................########.......#######...........########.............###.#####............##
##..............#####...................########...........................######.......#######..........#########.............#########............##
##...............###...................#########..........................#########.....#######..........#######...............########.............##
##.....................###............##########.................#.......###########.....######...........####................#######...............##
###...................#####..........###########...............####......###########.....######...............................######................##
##....................######........###########...####.........#####.....##########.......####.....###........................#####................###
##....................#######.......##########...######........######....########..........##.......##...........#######.....####.................####
##...........###........#####........########....######........#######...#######.....................#..........##########..####.................#####
##..........#####.......######...................######.......########....####..................................################.................#####
##..........#####.......#######...................#####.......#####..............................................###############.................#####
##.........#######......#######....................####......######...............................................##############.....####.........####
##.........#######.......######.....................###.....######.................................................#############....######........####
##.........######.........######...........................#######..................#######........................########.###...#######.........####
##.........####............#####...........................#######.................##########.......#######........###########...######...........####
###......######............######..........................######.................############..############.......#########....######...........#####
###.....######..............#####................##.........###..................##########################........#########...#####.............#####
###.....#####...............#######.............####............................#######.....##############.........########...######..............####
###.....####................########............#####...........................##...........############..........#######....#####................###
###......##.................########............#####.........#####...........................#######..............######.....#####...........#....###
##..........................########............######.......#######...........................#####........####...######.....####............##..####
##...........................######.............######.......#######.....##.....................####.......######...####.......##.............###.####
##...........................#####.............########......#######....####.....................##........######...####.......................#######
##.............................................#########......#####.....####.......#######..................####.....##.....#...................######
##......................#......................##########......###.......##.......#########................................###...................#####
##..................######.....................###########.......................###########..............................#####...................####
##.####.............#######.....................############.....................############............................######....................###
########............#######.......................###########......###............###.########...........................######...##...............###
#########.............####.........................##########......####................########...........###...........#######..####...............##
##########..............................................#####......###..................#######..........####....##........###..#####...............##
#########....####........................................................................######...#......####...####............#####...............##
########....######........................................................................####............##....#####...........#####...............##
#########...#######.............##.........................................................##...................#####...........#####...............##
#########...########...........####..........####...............................................................#####...........####.......###......##
#########...#####.###.........######.....############............................................................###.............##.......############
#########....########.........#######..#######################..............#########.....................................................############
########......########.......##################################...........##################......######..................................############
###.............######........#############.###################..........####################....########...........................###....######.#.##
##......###.....#######..........#########.####################..........#######..############...########.........................######...####....###
##.....######...#######..........########...###################..........#######....##########......####.........................#######...#####...###
###....#######..#######...........######.....#########..#######...........#####.......#######........#.##......................##########.#######..###
###...#################............#####......####.......#####.........................###............#####................#######################.###
##....#################............#######...............#####......................................########.......####...############################
##....#################....##......########..............#####.....................................#########......######.#########.###################
##....###############.....####....#########..............#####.........................##..........##########....################.....################
##....###.#########......#####....#########..............####..........................###...............####....#######.....###.......###########.###
##....########...........#####....########..............####......................#....###................####....#######................#############
##.....#####..............###......###.###..............###........#.............###....##.................####....######..................###########
##......#####.......................#####...............##.......................####..........#...........#####.....###....................##########
##.......#####......................#####...#....................................#####......................####...................####......#########
##.......#####......................#####..###....##.............................######.......................###.................######......##.#####
##.###....#####..............#.......####.####...####............................########....................#####.................#####.......#######
#######...#####..............#........#########...##..............####...........#########.................########.................####.......#######
########...####........................########..................######..........#########.................########.............................######
########....##..........................#######.................######.......#...#########................#########.............................######
#########..........#..............#........####.............................###...#######....#.............#######..########....................######
##########.........#............####......####......#.......................####............###.............#####..################..............#####
##########......................#####...#######.............................####............####...................#################..............####
##.#######......................#####.##########............................#####...........#####..................#################.......#......####
##.#######............#####.....#################............................####...........######..................################......###.....####
##.#######...........#######.....################..............###.......##...##............#######.................###.###########......####.....####
##.#######..........#########.....########.#######.....##.#########.....####................#######.................##...#..#.............##.....#####
##.######..........##########......####.##########....#############.....#####................####......#####.....................................#####
##.###.............##########.......###.....#####.....#############......######....................##########................#...............###.#####
##..#.......##......##########.....###................############........######.................############...............###.............##########
##.........####........########.....#..................#########...........######..............#############...............####............###########
##........#####...........#####.........................######..............#######.........###############................###............######...###
##........#####.............###..............................................#########.....###############..................##......###########....###
##........####.............####...............................................############################........##..............############.....###
####.......##..............#####.........................................##....##########################........####............############....#####
#####......................######.......................................####....#####################.##........#####............############...######
######......................######......................................####......###################...........#####...........############....######
#######......................######...........##..........#####.........###.......##################.............####...........###########.....######
########...........######.....#####..........###.......########....##....#.....###################................###...........####............######
##.#####..........######.......####...........##......#########....##.........###################..................#....##########..............######
##..####...#.......######......####...................########.....#.........####################......................##########................#####
##...##.............#####......####....................######...........###.#####################......................#########..................####
###..................#####.....####.....................####...........##########################................#......#######..........###.......###
####..................#####....####...................................#############..############.....###..............................######......###
#####.................######...####...................................########.......############...#####.............................#######.......##
#####.................######....####.................##............#########..........##########...#####..............................#######.......##
##..................########....#####...............###............###.######..........##.........#####...............................####.##.......##
##.................#########.....####....#.........####................######....................#####................................########......##
##..................#######.......##...............####.................#####.................#######.................................########......##
##...................####.........................#####.......####.......####...............########...........###....................########......##
##................................................####.......######......#####.............########...........########.........#......########......##
##.....#..............................##...........##........#######......#####...........########............#########.......###.....#########.....##
##...............##..................####....................#######.......####........###.#####..............#########.......##......##########....##
##..............####.................#####...................#######.......#####.......########...............#########..............###########....##
##..............####................######..................########.......#####.......#######................########...............###########....##
###.............####............##########......###.........####.###......#######......######...######.........#######..............############....##
####.........#######...........############....#####.##...###########....########......#####...########.........######..............#######........###
######......#########.........##############...######################...#########......#####..############.......######............#######........####
######################################################################################################################################################
######################################################################################################################################################
