###########################################################################
###########################################################################
##.....###############################..########.........###.......########
##......##############################...#######.........###..........#####
##......##############################..########.........####..........####
##......########################################.....##...######.......####
#####..#########################################....####..#######......####
#################################################..##############......####
##################################################################....#####
###########################################################################
###########################################################################
###########################################################################
#############################..############################################
############################....###########################################
############################....###########################################
#############################..############################################
###########################################################################
###########################################################################
###############################...#########################################
##############################.....###########################.############
##############################......#########################...###########
##############################......########################....###########
###############################....#########################....###########
############################################################....###########
########################################....########..#######....##########
#######################################......######....#######...##########
#############..########################......#####.....########.###########
############....#######################......#####....#####################
############.....######################......######..######################
############..........##################....###################...#########
#############..........#####..################################.....########
#############..........###.....###############################.....########
############...................################################...#########
#########......................############################################
########........#..............############################################
########.......###.............#####################...####################
########......####.....##......####################.....###################
#######.......###.....####....#############..######....####################
######...............#####################....#####....####################
######..............######################....#####.....##.....############
######..............######################....#####................########
######..............#######################..#######...............########
######..............#################################.............####.####
######..............##################################....####...####...###
#####...............###################################..############...###
#####.....#.........##################################################.####
####......##........#######################################################
####.....##.........############################.##########################
####.....##.........###..##################################################
####....###.........##....#####..##########################################
#####..#####.......###....####...##########################################
######################....####...##########################################
#######################..#####....##########################...############
##############################....#########################.....###########
##############################...##########################.....###########
#############################....###########################...############
#############################....#####.####################################
#############################....######.###################################
#############################...###########################################
#############################...###########################################
#############################...###########################################
##############################.##################################.....#####
################################################################.......####
################################################################........###
###############################################################.........###
###############################################################........####
##############################...###...#######################.........####
#############################.........########################..........###
#######..##########..########........#########################...........##
######....########....########.......##########################..........##
######....########....########......############################.........##
#####.....#########..#########.....###################################..###
#####.....#################################################################
###########################################################################
###########################################################################
