######################################################################################################################################################
######################################################################################################################################################
##################################.....########################...........###################........#############........#############............###
######.......####################......########################...........####################.......#############..........#...########..........####
#####..........###############..............###################..........####################.........#############..............########.........####
####............########.....................##################..........###################...........#############..............########.......#####
##.#.............######.......................#################...........#################.............#############.............#########.......####
##...............######.......................#################............###############..............##############............#########........###
##...............######.........##............#################...............###########...............##############.............########........###
##..............########.......###.............#################...................##...................########....................#######........###
##.............##########.....#####..............###############........................................########....................#######........###
##............############...######...............##########..###.......................................#######.....................#######........###
##...........######################...........#....########....###....................####.............#####.......................#######.........###
##..........########################...............########....#######..............#######...........#####.......................#####............###
##.......##############..############..............########....##########....#############..........######......................####..............####
##.......#############....############............#########....###########################........#######........................##............#######
##......###############...###############........###########..############################......########.........................#............########
##......##################################################################################.....######...........................#.............########
##......##################################################################################....######..........................................########
##.......#################################################################################....######..........................................########
##.......########################....#################################################.####..#######......................#....................#######
##........#######################.....######..#######################################...############.......................##....................#####
##.........######################.....#####....############....######################....############.....................##....#.................####
##..........######################......###.....########........#####################.....##.......###...................###......................####
##...........#######################.....##.....#######.........#####################...............######...............###......................####
##...........########################...........######.........######################................##########...........##...............#......####
##..........###########..###########.............####.........#######################.................#########...........###..............#.....#####
##.....#.######...####....#########...............###......############..###########..................##########..........##............##.......#####
##........####.............#######................###.....############....##########..................###########......................####.......####
##..........#..............####....................###.....##########.......######....................###########.....................#####.......####
##.........................###.....................###.....##########.....................................########....................#####.......####
##..................................................###....##########......................................########..#...............######.......####
##...................................................###..###########.......................................###########..............####.........####
##...........................##...#####..............################....#..................................############.....#......####..........####
##...........................#########..............################.....##........................#........#############...###########...........####
##..........................######.................################.......##..........#...........#........###########################.........#..####
##..........................####...............##########..########.......###.......#####.......###.......############################............####
##.........................####...............##########....#######........########################......#############################............####
#####.......................##..........###############.......#####........########################.....##############################............####
######......................##..........##############.........####........#######..###############.....#######..........#############...........#####
#######................................######..######...........##......#..######....##############.....######............############...........#####
########..........................#....####......................#..........#####....##############.......................#############..........#####
#########.........##.............#.....###...................................###......#############.......................##############.........#####
#########.......####..................###.....................................#.......##############......................###############........#####
######..........####...................#...............................................##############.....................################.......#####
######...........###.....................................#..............................#############..................#..#################......#####
#####...........####.....................................................................############.....................####...##########......#####
####............####......................................................................##########......................###.....#########......#####
##..............####.....................................#####.............................########......................###......#########.......####
##.........#########....................................#######.............................#####.......................###.......#########........###
##......############....................................######.................##.............###....................######.......#########.........##
##.....##############..................................######...........##########..................................######........##########........##
##......##############.....................#...........######.........###########...................................######........#########.........##
##........############............############........####............##########....................................######........########..........##
##.........###########..........###############......####.............##########.....................................#####.......######.............##
##..........###########.........################.......................#########............................#........#####......######..............##
##............##########.......##################.......................########..........##.................##.......#####....#######..............##
##.............##########.....####################.............##........#######.........#####...............#.........#####..########..............##
##..............###################################......##...###........########.......######..........................##############..............##
##...............###################################...####...####.......#########.......#####...........................##############.............##
##................########################################....#####......#######..........###.......................................###.............##
##.................###########.....#####################......#####......######............#.........................................##.............##
##......#.#.........#########...................#######......######......#####..................................##....................##...........###
##.......######.....########.....................#####......########....#...........#...........................##########............##...........###
##.......#######.....#######......................###......########................###....................#.....#############.........##..........####
##.......#######......######.......................##.....########................#####..................####.....###########.........##.........#####
##.......#######.......######......................###...#########................######................####.......##########.........##.........#####
##.......#######........######.....................###############...............########.........#########........##########.........#..........#####
##.......#######.........#######...................###############...............#########......##########.........##########........##..........#####
##.......#######..........########.................###############...............########################...........########........###..........#####
##......#######............#######.................####..#########..............########################............#######.......#####..........#####
##.....#######.............#######................####....#######...............#######################.............######......#######.........######
###...#######..............########.............#####.......#####...............#######.....###########.............######......######..........######
##...#######.......##.......#######.............####.........####...............###..........##########.............######......###.............######
##.....####........##........#######...........#####.........#####..............##............#########.............######.......##............#######
##......#..........##..........#####..........######........#########............#.............########.............#####..........#...........#######
##...............................####.........#######......##########.............#.............########............####......................########
##.................................#...........######################............###.............########...........####.....................#########
##.............................................######################.....#.......###.............########.........#####..........................####
##.............................................#############....####..............#######..........########.......#########........................###
##.............................................############......###...............########.........########...############.........................##
##.######......................................############......####..................####.........#######################.........................##
#########.....................#................###..#######......####...................###.........#######################.........................##
#########....................###...............##.....######.....#####...................#...........######################........#................##
#########......##............####..............##......#####......###.................................###############....#......####................##
#########.....####..........#####..............##..............#......................................##############............####................##
########......#####..........#####.............###...................................................###############.............###...............###
#######......#######.........#####............#####........................................#........################.............##..............#####
#######.....########..........####...........##########.....###...........................###.......########....####.............##............#######
#######.....########..........#####.........##################....................###########......########......###.............##.........##########
#######.....########..........######........##################............###################......########......###.............##........###########
#######....#########..........#######......##################.............###################.....#########.......##............####.......###########
########..###########..........########....##################............####################.....#########.......###...........######....############
###############.#####..........#############################.............###################......#########........##...........########...###########
#####################...........####################...#####.............###################.......########........##..........########....###########
##.###################..........##################......###...............##################........#######........###........#########....###########
##....###############..............#############.........##................###...###########........#######........##........###########..############
##.....##############...............#######.......................................##########........#######..................#########################
##.....#############.................#####........................................###########......#########.................#########################
##.....#############.................#####........................................#############...###########.................###.....################
##.....############..................#####............................####........##############################........#...............##############
##.....###########....#..............#####........................#########.......#####....#########....#########........................#############
##.....##########.....##.............#####..........#...............#######.......####......#######......########..................#......############
##.....#########.....................#####.........#...........#.....#####.......####........#####........#######.................##......############
##....##########.....................######...........................####.......####........#####.........#######..............#####.....############
##...###########.....................#######.........................#####......#####.......######.........#######..............######....############
##.######..####.......##............########.......................######.......######........###.........########.............########...############
########.....#.......#.............##########....................########.......########.................##########.............######################
########..........................###########....................########......#########..................##########............######################
########...................####.#############....................########.....#####...#...................###########...........######################
########....................#################....................#########...#####.....#...................#####...#######.....#####.........#########
########.....................################....................#################...........#.............####.....###############...........########
########.......................##############..................####################...##.....##............####......############..............#######
#######.........................#############..................#########################.....###..........#####.........########................######
#######...........####...........#############.................###############...#######....####.........######..........######..................#####
##..###.........#########.........############................###############.....######.....####.......########..........####...................#####
##...#.........############..........#########...............#####....#######.....######.....#........##########...........###...................#####
##...........###############...............###.............#####.......#######....######.............#######...#............##...................#####
##...........###############................##..........######.........########..#######............#######..................##...................####
##...........#########...####....##..........##.......######...........##################..........########..................###..................####
##..........########......####..###..........###.....###...............###################........#########..................####..####......#....####
##.....#########...........#######...........####...###...............######################################.....##..........################.....####
##....########.............#######...........#########...............##############################################.........################......####
###..########..............#######..........##########..............###############################################..........###############......####
############...............#######.........###########............#################################################..........##############.......####
########...................######.........#############..........##########################################......##...........############........####
#######....................######........###############.........####################################..........................##########........#####
#######.................#.#######.......########...######.............##############################............................########..........####
#######...............###########......########.....#######............############################..............................######...........####
######...............############.....###..###......########...........###########################......................#####.....#####............###
##....#...............#####..#####..####................####..........############################......................######.....####............###
##.....#...............###....#########..................###.........#############################.......................####.......####............##
##..........#..........##......#######..............................##############################.......................####........####...........##
##.....................##......#######..............................#######....####################.......................##.........#####..........##
##.....................##.......#####................................#####......######################...............................######.........##
##.....................##.#.......##..................................###........####################................................#######........##
##.................................#...............##..................#..........###################................................#######........##
##.................................................###.............................#################.............................############.......##
##......................................###........###..............................################..............................############......##
##......................................###........###......................#.......###############....#...........####............###########.....###
##.....................................####.........###.........#...........##......##############.............########.............###########....###
##................................########...........##........##..........###......#############.............########..............############...###
##..............................##########...........#........###..........####.....#############.........############..............###########....###
##................#####.........###########..................####..........####.....#############.........#############.............###########...####
##...............#######........############................######........#####.....#############...........############............###########...####
##............############.....##############...###......##########......######....##########.####............############.........###################
######......########################################....########################..######################.......#######################################
#########################################################################################################.....########################################
######################################################################################################################################################
######################################################################################################################################################
