###########################################################################
###########################################################################
##....##############........#..........#######.........#############.....##
##....################.................#######.........#########..###....##
##.....#....##########.................########........########....##....##
##............#######..................###########.....#######.....###...##
##.............######........#............########.....###..........#######
##................#.........................#####......##...........#######
##............................................##......###...........#######
##....................................................###............######
##...............................#....................####............#####
##..#............................##..................######............####
##..#...........................###.................#########..........####
##..............................####...............#########...........####
##.............................#####................########...........####
##............................#######...............##....##...........####
##......#####............###########..................................#####
####...########.........###########.................................#######
###...#########........###########..................................#######
##.....########.......###########..........#.........................######
##.......######......###########...........#.........................######
##.........#####....###...####.............##........................######
##.#........##########.....................##................#.......######
##...........########......................###.......................######
##...........########.......................###.......................#####
###.........#########.......................####......................#####
####.....############........................######...................#####
#####################.........................#####...................#####
####################..........................#####............#.......####
####################.............#.............####...........###......####
####################............##...............##..........#####.....####
###################.............##................##........#######....####
##############....................................##........####.......####
############.........................#.........######......####........####
###########..........##.......................#######.......##........#####
#########............####....................#########......#........######
########.............#####...................##########......#.......######
#######..............####.............#..........######.............#######
#######.............#####............##...........#####.....#.......#######
##.####..............####...........####.............##............########
##..###............................#####..............#...........#########
##.####..........................#######..........................#########
#######..........................#######..........................#########
#######.........................#########......#..................#########
##.###.........................##################................##########
##....#.......................####################.........#....###########
##...........................######################..............##########
##........................##########################.............##########
##........................##########################...............##....##
##......#.....#...........#####...###################....................##
##........................###........#################...................##
##.......................###.........############..##....................##
##.................#.................############..###...................##
##...................................##################..................##
##...##..............................##################...#..............##
##..####............................###################..................##
##..####..........................####....##############................###
##..####.......................######.......###########.......#........####
##.#####......................######.........########.......#..........####
########....................#######..........#######.....#.###........#####
########..................########............#####.......####.......######
#######...................########............#####........####.....#######
#######...................########.............####........################
######....................########..............###........################
######............###.....#########........................#######..#######
####.............####....##########........................######...#######
###................#.....###########.......................#####....#######
##.......................############.....................#####.....#######
##................#.....######..####.....................######.....#######
##.....#................#####....###..........#.........########...########
##...####....###........#####....###........#####......####################
###################....######...#####.......#######...#####################
#######################################.....###############################
###########################################################################
###########################################################################
