###########################################################################
###########################################################################
##.........#####............###############......#######################.##
##.........#####...........################......######################..##
##.........######.........#################......######################..##
##...........#####......####################....######################...##
####............##################........#...#..######################..##
#####.............###############.................#########################
##.###.............#############...................########################
##...................##########.....................#######################
##....................########.......................######################
##.....................######.........................###############.#####
##.......................####..#..........####........##############...####
##........................###..........#######........##############..#####
##........................###.........#######.........#####################
##.......................#####.......#######..........#####################
##.........................####.......###............######################
##...........#.................#....................#######################
##..#..........................#...................######...###############
####................................................####.....##############
####.................................................###.....##############
###..................................................###.....##############
##....................................................###...#######......##
##.....................................................###########.......##
##......................................................#######..........##
##.....................................###..............###..............##
##...................#................####..............##...............##
##...................................######.............##...............##
##..................................######..............###..............##
##..................................######..............####.............##
##..................................######..............####............###
##.....................#####.......########............#####...........####
##...................########......##########.........#####..........######
##..................##########.....#############....######........#########
##........#.......#############...#######################........##########
##.......###.....########################################.......###########
##......###################...###########################.......###########
##.....###################.....##############.........###.......###########
##.....##################..............###.............##......############
##.....##################...............................##....#############
##.....#######......#####...............................##.###########..###
##......#####..............................................##########....##
##......#####...............................................########.....##
##......######..................................#.................##.....##
##.......######.................................###......................##
##........#######........................##.....###......................##
##........#######.......................###.....###......................##
##........#..###................#.......##.......##.....................###
##..............................##......##.............................####
##......##......................##................#..................######
##....####.....................##...................................#######
##########..................#####...................................#######
##########...........#......#####..................................########
###########.........###.....####...................#....#.#.........#######
###########.........###.....###.....................######.....#......#####
############.......####.....###.....................######....##.......####
##..#########.....######....##.......................####....####.......###
##...##########..########...##.................#.....#........###........##
##....##################......................................###........##
###....#################......................................####......###
##......###..###########......................................####.....####
##............#########.......................................#####...#####
##...........##########.......................................#############
##..........##########.........................###............#############
##.........###########.......................####............##############
###.......############................##....####..........#################
#####################...............############........###################
##.##################..............#############........###################
##..#################..............#############........###################
##..#################..............##############........##################
#####################..............###############.......##################
#####################.............#################.....###################
####.#################...........#######..#################################
###########################################################################
###########################################################################
