###########################################################################
###########################################################################
##......###########.....###################.....###########################
##......##########.......#########...######......##########################
##....##########...........######.......#........##########################
##...########................####.................#########################
##..#########.................###.................###################...###
##############................#...................###################....##
###############...................................##################.....##
##############........................#...........##################.....##
#############.................................#...........#########.....###
############................................###............#######......###
##..#######.................................###............#######.......##
##..######........#.........................##.............#######.......##
##..#####.......###.........................##.............######........##
##....##.......####........................................######........##
##.....#.......####........................................#####........###
##.............###.........................................####........####
##.............##....................####..................###........#####
##...................................####..............#...###........#####
##..................................####...................###.........####
##.................................#####..................####........#####
##..............................#.#####...................###.........#####
##...............................######...................##.........######
##...............................#######..........................#########
##...............................########.......................###########
##...............................##########.......#.............###########
##...............................##################............############
##................................#################.............###########
###...............................##################...................####
####......###......................##################...................###
#####.....###.......................#################.................#####
######....###......................#....#############................######
######....###.....................#......#############...............######
#####.....####............................################............#####
###......##########........................################............####
##........###########.......................###############............####
##........############.......................###############...........####
##.........############.........................###....#####...........####
##..........###########...............................................#####
##..........############..............................................#####
##..........############...............................................####
##...........############...............................................###
##............###########...............................................###
##.............###########..............................................###
##..............##########..............................###......##....####
##...............#########...............................###....###########
##................######.................................##################
##.................###....................................#################
##.................##......................................################
##.....................................#....................###############
##..........................................................######..#######
##........#......................................#..........#####...#######
##.......................................#.......#.........######....######
##........#.....#.........................................######.....######
##.......................................................#######.....######
##......##........#....................................#########.....######
##.....###............................................###########...#######
##########..............##.........................########################
##########..............####..............#.......#########################
##########..............#........##..............##########################
###############..................#.............############################
###############.............................########...####################
################...........................########.....###################
###############......#....................#########......##################
##############.......#..................######..##.......##################
##.########.............................#####............###########.######
##..######................##.............###.............##################
##.######................####............###............###################
#########.........#......#########.......####..........####################
##########......###.....###########......#####.......######################
####################...#############....######.....########################
##############################################....#########################
###########################################################################
###########################################################################
