###########################################################################
###########################################################################
######........#....##############################.#.................#######
####.....................#######################...........#......#########
###......................######################...........###....##########
##........................#####################............##....##########
##..............#.........######################.................##########
##........................#######################..#............###########
##........................#############.........###.............###########
##............................####..............###............############
##.............................###..............##.......#....#############
##......................................................###################
##......................................................############....###
##.....................................................#############.....##
##............................................##......##############.....##
##............................................##.......#############.....##
##............................................#.........############.....##
##.......................................................############....##
##.......................................................##################
##.####...........#............................#.........##################
##.#####.......................................###.......##################
#########.....................................#######....######......######
##..###......................................##########...####.......######
##...........................................##########....###.......######
##...........................................##########.....###......######
##............................................#########......###.....######
##.................#...........................########..............######
##.................#............................######...............######
##................##...............................##................######
##.................#....#...................................##......#######
##.....................####...............................####......#######
##.....................#####...............................####.....#######
##.....................######..............................#####...########
##....#.................###.................................#####..########
#####...........................................................###########
####............................................................###########
###..................................#..........................###########
##.................................###..#.......................###########
##.................................####........................#######..###
##.................................####........................#######..###
##.#...............................####.........................###########
######..............................##..........................###########
########........................#...##............#..............##########
##########......................#..###...........................##########
#########......................######.............#..............##########
#########......................######.............##.............##########
#########......................#####..............##.............##########
#########.......................###................#.............##########
#########........................#...............................##########
#########........................................................##########
#########......#.......................................#.........##########
##########....##......................................#####################
#################.....................................#####################
################.......................................####################
############..##.......................................####################
############..##.........................................#####....#########
################....................##.....................###......#######
####..#########...................#####......................##.....#######
####..##...........................#####.....................##############
##.##................................##......................##############
##.###...............#.......................................##############
##.##.........................................................#############
##.##.................#.......................................#############
##.##.........................................................#############
##.##.........................................................#############
##.##.........................................................#############
##..###......................................................##############
##...######..............#####............................#################
##...#######............#######.........###.............###################
##...##########################........#####.........######################
##..########################..###############..############################
##.#########################..#############################################
##.########################################################################
###########################################################################
###########################################################################
