###########################################################################
###########################################################################
##.......#####..........................###..........#..#..........########
##......######..........................##..........................#######
##.....########.....................................................#######
##...##########...........##....#.......#.#..........................######
##.###########.............###############...............................##
#############...............##############...............................##
##.#####....................#############................................##
##..###......................###########............#....................##
##.####......................########..............####..................##
#######..........###..........######...............###...................##
########......#####...........#####................###...................##
##################...........######...............###....................##
################.............#######..............###....................##
##.##########...............########...............##...................###
##.........................##########..............##...................###
##........................###########...............#..........##.......###
##...........#.........#.##########...........................####......###
##........................########............................####.....####
##.........................#######...........#................###......####
##............................####..........###...............###......####
####...........................###...........###..............####.....####
######..........###.............##............###.............###.....#####
########.......#######..........##............#####...........###.....#####
#######################........###.............######........####.....#####
########################......###...............######.......####.....#####
#########################....###..................####.......####.....#####
##########################..###.....................#........###......#####
#############...##############.......................#.......##.......#####
#############.....############..............................###.......#####
#############......#...######.............................#####......######
#############..........#####..........#....................####.....#######
##.#########...........#####..........##..................#...#....########
##.#######.............####..........###.................#.........########
##..#####.............#####.........####...........................########
##...###.............######.........###............................########
##...#.............########........###........................#....########
##.................########........###.............#........####..#########
##.................###.####.......####.............##........##############
##.................#######....#########............##...........###########
##.................########.############............##..........###########
###.................######################...........#..........###########
###..................######################...........#...........#########
####..................#####################........................########
####...................#####################........................#######
###......................###################........#................######
###........................#####...##########....###..................#####
##...........................##....###########..####..................#####
##.................................##################..................####
##.....###.........................###################.................####
##.....###.........................####################...#............####
##......##.........................#####################...............####
##......##..........................#####################..............####
#####....#...........................######################............####
#####....#............................######################..........#####
####...................................######...#############.........#####
####....................................####......##.....###.........######
####.............####...................####.........................######
####....#........####...................#####.........................#####
####..............###....................####.........................#####
###................###......#............####............#............#####
##.......#..........##.....##.............###...........###...........#####
##......###.........###...##..............##............######.......######
##......####........########............................#######..##########
##.......####.......#######..............................##################
##........####......######................................#################
##........#####....###....#................................################
##........############......................................###############
##.........###########.......................................##############
##.........############.........##.................#.........##############
##.........#############...##..####...............#####.....###############
##.........#########################.............##########################
###########################################################################
###########################################################################
