######################################################################################################################################################
######################################################################################################################################################
#########....##################..........######################..........#################............##########...................#####...........###
#########....##################..........######################...........################...........############.................#######.........####
########.....#################............#####################............##############............#############................#######.......######
#######.......#########...................####################...............############...........###############...............#######.......######
######.........########..................#....################..................#########..........################...............########.....#######
######.........########........................############......................#....###....########...############..............#######......#######
##.............#########........................##########.............................##....#######.....##########..............########......#######
##.............##########.......................#########..............................##..........#.....##########..............#######.....#########
##............###################...............#########........#####................###................#########......#........#######......########
##.......##..#####################..............#########........#####...............####...............####.....................#######.......#######
##.......#########################...............########........######.............#####.............#####......................######.........######
##.......#########################...............########.......########..#........######...............................#........#####.........#######
##......###########################..............########......##########################........................................#####........########
##......##############################...........########......###########################........................................####.......#########
##......################################....#...##########....#############################.....##................................#####......#########
##......###########################################################################################...............................#####......#########
##.......##########################################################################################...............................######......########
##.......##########################################################################################........................#......######.......#######
##.......###############################################.......####################################...............................#####........#######
##........#############################################.........#####################.......########...............................####........#######
##.........########################..#################..........####################.............####..............................####.........######
##.........########################.....##############..........####################..............####..#..........................#####.........#####
##.........########################........###########..........####################...............#######.........................######.........####
###........########################...........########..........####################................########......................####.###........####
###.........#####........##########............#######.........########..##########.........#........########.....................#########.......####
##...........#.............########.............######.........#######....#########.........##........########....................##########......####
##..........................######...............#####........#######......#######....................##########.................###########......####
##...............................................######......#######.......#######.....................##########................############.....####
##.......#........................................#####.....#######........#######.......................#########...............#############....####
##................................................#####....#######.........#######........................#########.............##############....####
##.................................................#####..########.........#######.........................#################...#########..........####
##.............................##...#..............##############..........########........................############################...........####
##............................####..###########...##############...........#########.......................###########################............####
##..........................#.#.....##################.......#............#############.............#......###########################............####
##...................................################.....................###############.........####.....###########################...........#####
##...................................###############.....................############################.....######....##################...........#####
####................................###############.......................###########################......####..........##############..........#####
#####..............................#############..........................##########################.......####...........############...........#####
######............................############.............................########################........###............############...........#####
######...........................###########................................######################.................#......############...........#####
#######............######.......######...................##.................#######.##############................#......#############...........#####
#######............#######.....#####.....................###.................######..#############...............##.......#############..........#####
######..............#######...#####.....................#####.................#####...#############..#..........###.......##############..........####
######..............##############.....................#######.................#####..#################.........####......###############.........####
######..............#############.....................###########..............#######################.............#.......##....########..........###
#####...............#############.........##..........############.................##################.............................########..........##
#####.........##...############...........###........#############..................############..................................########..........##
####.........##########...####............###........############...................###########..................................#########..........##
####.....#############....###.............###....#...############..................############...........##..........###.......##########..........##
#####...##############....###.............##.........############................############..............#.........######....##########...........##
#######################....###...........###...........##########.........###########..####..........................#######..###########...........##
########################....################................#####........###########....##...........................####################..........###
#########################....################................####.......############....##............................##################...........###
#########################....####################.............###.......############....##............................##################...........###
##########################....####################.............##.......#######..####..####...........................##################...........###
##......##.....###########.....###################............###........######...##########..........................######....########............##
##..............##########......###################...........###.........#####....#########.........................######......######.............##
##...............#########.......##################...........###.........#####.......#######.......................######........#####.............##
##................########........##################.........####..........................##.......##.............#######.........####.............##
##.................#######........#####........######........####...........................#.......###...........########..........##..............##
##...................#####........####..........#####........####...................................####.........##########.........##.............###
##....................####.........##............####.......#####....................................###........############........##............####
##.......#.............####........#..............###...#..######................###.................####......#############.....................#####
##......###.............####......................####...########...............#####................#######################.....................#####
##.....#####............#####.....................###############...............######...............###########.##########......................#####
##.#...######...........########..................###############..............########.............#######################......................#####
####...######...........########..................###############...#...##....##########..........##########..#############......................#####
#####...######.........##########................################...#####################........##########.....###########......................#####
#####....####.........###########...............#####...#########....#####################################.......##########........#.............#####
##........##..........############.............#####......#######....###...............#################..........#########.......###............#####
##.......#............##...########............#####.......#######..###...................#############...........#########.......#..............#####
##...................#......#######...........######........##########.......#.............############...........#########......................#####
##..........................########.........#######.........########.......#...###........############..........#########..............##.......#####
##..........................########........########........#########.....##....####........###########.........#########...............####.....#####
##...........................#######........########......###########.....##...######........##########........##########................#####...#####
####........................................##########..################...#...########.......#########........##########................####....#####
#####......................................#############################.......#########.......########........#########.................###......####
######...................................##################....#########.......#########.......#########.......#########................####.......###
#######..................................#######...#######......########.......##########......##########.....#########.................####........##
#######.......###........................######.....#####........#########.....####...####.....########################................#####........##
#######......####.........................#####.....####..........######......####.....###.....######################..................#####........##
########.....####..............#............###..............................###.......####.....#..################.............#.......####........##
########.....####.............###............###.........................................#..........##############.............##...................##
#########...#####.............###....##......####...................................................##############............####..................##
########.....#####...........#####..###......#####..................................................#############.........########..............######
#######......#####...........###########.....######.................................................############.....#############............########
#######......#####...........############...############....................#..######..............############.....##############...........#########
#######......#####.......#...#####################################.........#################.......###########.......##########.###.........##########
########....#######..........########################################.....##################.......###########........#############........###########
####################..........##############################################################.......###########..........############......############
#####################...........####################.....###################################.......###########...........############....#############
#####################............##################.........################################.......##########.....#.........##########################
##.###################............################...........###.###########################.......#########.................#########################
##..##################.............##############.............#....####..###################......#########..................#########################
##...###############...............##############...................##....##################......########....................########################
##...##############................#################................#......##################.....########..........#####.....########################
##...#############.................#################.......................###################....#########........######.....########################
##....###########...................########..#####.............................#########################################......#######################
##....##########....................#######....###..................#............#######..################################.....#######################
##.....########.....................######..............#...........##............#####....################################...########################
##.......######......................#####..................#.......###...........#####.....#########......###########################################
##........#####......................#####.................######..####...........#####.....########........######...##################..#############
##..........###......................#####.................############...........#####.....#######.........#####.....################....############
##...........#......................######.....................########...........#####.....######..........#####......###############....############
##.................................#######......................########..........#####......#####.........######........###.##########..#############
####..............................########.........#.............#######..........#####......#####........########............########################
####..........................#############......................########...........####......####........#########...........####.###################
#####........................###############.....................#########..........#####.....####.......#####..##########...#####.###################
######.......................###############.....................##########.........######...####........####.....################.#######.###########
######........................###############....................##############....#############........#####......####################.....##########
######.........................##############...................################################........#####.......##########...#####.......#########
######..........................############....................###############################..........####........########.....###........#########
#######...............##.........###########.........................##########################..........#####........######.......##.........########
########.....############........########.............................#######.################...........#####.........#####........#...........######
##....####################.......#####................................#######################...........#######.........#####..........#.........#####
##.......##################......####.................................#######################..........####.............#######........##.........####
##.........#################....####.....................#............#######################.........####...............########.....######......####
##..........#####......############.....................##............########################.......#####................#######.....#######....#####
##..........####........###########....................##............##########################...########.................#######...#################
##..#......#####.........##########...........###.....##.........##########################################.................######.###################
################.........##########.........#########............###############################################.............###############....######
################..........#########.........##########...........################################################.............############.......#####
#########...####...........######..........###########............######################################........##.............##########.........####
########......#............#####...........###########............####################################..........................########...........###
#######...................######..........#############..............###############################..............#.............#######............###
#####....#................######..........##############..............#############################..............................#####.............###
##.......................########.........###############.............############################.....................####......#####.............###
##......................##########........#######.########..........##############################.........###.......#####........#####............###
##.....................#############..........#########....#.......################################......#####.....#####..........#####............###
##..............#####..##...#########..........#######.....##......##########################################......#...............#####...........###
##.............#######.........#######.........#######.....##.....########################################.........................#####...........###
##.............######............#####.........#######......#.......##########...########################...........................####...........###
##.............#####..............####........########...............########.....##################................................#####..........###
##..............###................####......########......#..........######.......################................................#######.........###
##..................................###..........####..................####........###############.................................###################
##..................................####..........##....................###.........#############.................................####################
##...........................#......#####..........#.....................###........############..................................####################
##.................................#######................................######....###########.....................#.............####################
##.................##........##...############..............###...........#######...###########....................................###################
##.................###.......###################............######........######....############.................###...............###################
##..........###...####.......####################...........######.......#######...###############.............#####...............###################
##.........############......#####################.........########.....########...#################.........########.............####################
##.........#############.....######################........#########...#########..###################...#...##########...........#####################
##..........#############...###########################################################################################........#######################
##.........###########################################################################################################################################
###.......############################################################################################################################################
######################################################################################################################################################
######################################################################################################################################################
