###########################################################################
###########################################################################
##########..........###.....###...........#######################.....#####
############.......#####...###...........########################....######
############.......###########..........###################################
#############.....###########..........####################################
##############...############.........#####....##########.....#############
#######################..#################......########........###....####
######################....###############.......###.....................###
#####################....####....########...............................###
#########...########..............#######...............................###
#######......######................#####................................###
#####........######................#####...............................####
####..........#....................#####..............................#####
##...........#....................######.....................#.......######
##...............................#######............................#######
##...............................#######...........................########
##......#............##..........######..........................##########
##........#......#######........#######.........................###########
##........############...........######.........................###########
##.........########..............######.............###..........##########
##...............................######.............####..........#########
##...............................#######..#.........########.......########
##...............................##########.........#########......########
##...............................##########.........##########....#########
##...............................###...###..........#######################
##...............................########..........########################
##...............................########...........#########..############
##...............................########...........#######################
##..............................#########...........#######################
##.............................####.######...................##############
##.......................#....####...###########..............#############
##......................########....###############............############
##......................#######....################............##...#######
##......................#######...#################..................######
##.....................########################.......................#####
##....................########################.........................####
##...................########################..........................####
##................##########################...........................####
##................#########################.................###..#......###
##...............##########################...............##.###.....#..###
##......#........#########################................#.............###
##...............########################........#......#...............###
##..............################..######................#...............###
##..............###############.....###.................................###
##.............###############..........................................###
##................############................................#.........###
##............#....#########............................................###
##..........###....########.....................................#........##
##.###.....####....#######......................................#........##
##############......###........................#.........................##
##.###########.......#...................########........................##
##....######............................#########.............#..........##
##.....###.............................##########........................##
##.....##...............................#########.......................###
##......................................##########.....................####
##.......................................######.###...................#####
##......................#..................##########.......#.......#######
##....###......#......#####......#...........#######.......####....########
##....###########....#######..................#####.......######..#########
##...###########.#..#########..............................################
##..###########....##########...........#...................###############
##.########.##.....###########.........######................##############
###########.##.......##########.......##########..............#############
#############...........##########################............#############
#############............############################........##############
#############.............#################################################
#############.............###################.....#########################
##############............##############...#........#######################
###############...........#############.............#######################
################.........##############..............######################
#################.......################...#.........######################
##################.....##################............######################
###########################################################################
###########################################################################
