###########################################################################
###########################################################################
#####################.....##.......########.......####.........#####....###
########....#...####...............#########.......###........#######...###
#######............................##########......###.............########
##.................................##########......##...............#######
##................................###########.....###................######
##.................................#########......###................######
##.............#...................#########.......##................######
##......##...######................#########.......##...............#######
##........########.................###...###.......##...............#######
##........#######......#..##......###.....###......###..............#######
##....#........#.........##........#...............###.........#......#####
##..####.................###........................#.#................####
##...###.................###.......................#...................####
##...###................########.......................................####
##...####..............##########.....................................#####
##...#####.........#..#############..................................######
##..######...........##############.....#..........................########
##...#####...........##############.............................###########
##....#####..........#############.....#.......................############
###....#####..............########.....####.....................###########
##.....#########............######....############................#########
##.....############....#.....#####.....###########.................########
##.....############...........#####.....###########.................#######
##.....#############............##.......###....###..................######
##....##############.............................###.................######
##....###############..............................#.................######
##.....#############..................................................#####
##.......######...##...................................................####
##........####.............................##..........................####
##.........###............................####...............#..........###
##..........#.............................###..............##..........####
##............................#............##........###.....#........#####
##............................#............##.......####.............######
###........................................##........###............#######
##........#................................#.......................########
##.........####...........................##.......................########
##..........#########......#.............###......................#########
##...........#########.....#...........####.......................#########
##............########................####........................#########
##..#.........########..............#####......#..................#########
##............########............######.....##....................########
##.............#######...........#######....####...................###...##
##.................##...........#########..#####.........................##
##..............................################.........###.............##
##.............................#################.........####............##
##...................#.........################..........####............##
##.....................#........##############...........####............##
##...............................#############...........#####...........##
##...........#...................#############...........###.....#.......##
##..........#.....................####..######...........##..............##
##.#....#..........................##....#####...........##..............##
##.#..######..............................####...........##.............###
##....######..............................#####..........##.............###
##....#####...............................######.........#.............####
##....####................................#######.......##............#####
##....####...................#............######........##............#####
##....####.....#............###...........#####.........###..........######
##......#..................####............###..........####.......########
##....................#...#####..........................####...###########
##....................#########..........................####.....#########
##...................########.............................###........######
##...................####.................................####........#####
##...................###..................................####........#####
##.#................###........................##.........####.......######
##.................##########..................##.........####......#######
##...............###########...................##.........#####....########
##.............############...................####.......#######..#########
##...........###########.....................##############################
##.#....###############.....................###############################
#####..################..............######################################
#######################............########################################
###########################################################################
###########################################################################
