###########################################################################
###########################################################################
##...........##.......###########################..................########
##.............#......###########################............#....######.##
##..........#............########################............###########.##
##........#................######################............##############
##......##.................######################............##############
##.........................#####...............##.............#############
##.........................####................................############
##..#.....................####.................................############
##.......................###..................................#############
##....................#####.............................###################
##.....................###..............................###################
###.....................##..............................###################
###....................................................############..######
####...................................................############..######
####........................................##...........##################
####........................................###...........#################
####........................................####...........################
#####.......................................#####..........################
####........................................######.........#####..#########
##.....#.....................................######........#####..#########
##...........................................#######.......##..############
##...........................................#######.......##..############
##............................................##..##.......####...#########
##................................................###......####...#########
##.....................................##........###.......####...#########
##....................................##.........###........##....#########
####..................................##.........##................########
##.###............................................#.................#######
##.####.............................................................#######
##..####...........................................................########
##....###................................................##........########
##.....###........................................................#########
##......###...................................#...........#.......#########
##.......###..................................#...........##......#########
##.........####................................#..........#......##########
##...........#...........................................##......##########
##......................#####............................##......##########
###....................########..........................#.......##########
#####..................#########.................................##########
#######...............###########...#...........#................##########
########...............###########.............###...............##########
########................#########.............#####..............##########
########................########...............####..............##########
########................######.................#####............###########
########................####....................................###########
########................####............................#......############
########................####.............................##....############
########.................###.............................###...############
########...................##............................###..#############
########...................###...........................##################
########..................#####...........................#################
########.......................#.......#.#................#################
#########........................##.......................#################
##########.......................###.......................#######..#######
####..............................#........................######...#######
###........................................#................#####..########
###.........................................................###############
###..........................................................##############
###.......#............................#........................###########
####....................................##......................###########
#####...................................#.......................#####..####
########........#........#...............#......................#####..####
##.#####................###.....................................###########
##..####................###............................#.....##############
##...####...............###.................................###############
##...###................###................................################
##...###.......#.......####........................########################
##...###.....##############......................##########################
##...###...################....####.............###########################
##..##################..#############.....#....############################
##.###################..###############..##################################
###########################################################################
###########################################################################
