###########################################################################
###########################################################################
######...............####.......############......................#########
#######..............######.....#############.....................#########
#######.............#######....##############.....................#########
########............########################...#..................#########
###..###.............#######################......................#########
##...###..............######################......................#########
##....###..............######..#############......................##..#####
##.....#...............######..###########.........###............##..#####
##.....................###...#.########.............#.............#########
##.....................##.........####.............#.......#......#########
##.....................##..........###.....................##.....#########
####...................##...........##....................#####...#########
####...................##...........##..###..............##################
####...................###..........##..###...............#################
####...................##...........######................#################
####...................##..........#####....#..............################
####....................#.........#####....................################
##.##..................#..........####.....................################
##.#####.......................##..........................################
##.#######..............#.....###.........................#################
##.#######.#..................###.....................#####################
#########.....................###....................###############...####
#########....................####..................##########..........####
########.....................#.....................#########...........####
########............#...............................########...........####
##.#####.....#.....###....................#.........#######............####
##.###............#####..............................#####............#####
##..#..............#####..............##.............####.............#####
##...................#####..........#####............###.............######
##....................####..........####.............##............########
##.....................##...........................................#######
##.....................##...........................................#######
##....................###............................................######
##................#######....................#........................#####
##...##..........#.######.............................................#####
##..###..............##...............................................#####
##.###................................................................#####
#####..........................................................#.....######
#####.........................................................##....#######
####..............................................................#########
####..............................................................#########
##########........................................................#########
###################..........................#####.................########
####....##########...........................####..................########
####....##########.................................................########
################.............#.....................................########
##############................#.#..................................########
#############......................................................########
############...................................................############
###########...................................#................############
##........#.....................................................###########
##...............................................................##########
##.........................#...........................###........#########
##.................##..................................####........########
##.................#...................................#####.......########
##.................#...................................#######.....########
##..................................................###########....########
##..................................................####...####....########
####........................................................####..#########
###.........#.......................###......................##############
##....................#............####.......................#############
##............#....................#####......................#############
##...........##.....................####......................#############
##..........####.....................###..................#################
##........######.....................####.................#####..##########
##........######.....................####................#####...##########
###......#######.....................####................#####..###########
##.##....#######....................######...............##################
##.###..########.......#..........#########################################
##.########################################################################
###########################################################################
###########################################################################
###########################################################################
