###########################################################################
###########################################################################
##############..........##..............#################...#######.....###
##############.........####.............############################...####
##############..........####............###################################
##############...........####...........###################################
#######.######...........#####..........###################...#############
######...######..........######........###################.....############
######.....#####.........#######......###################.........#########
######......#####........#################...##########.............#######
######.......#####......#################.....####...................######
######........#######....####......#####.......##.....................#####
##.###.........#######..............###.........#.....................#####
##..##.........#######..............##.................................####
##.............#######.............###........................#........####
##............########............####...............#.................####
##.............#.................#####..........................#.....#####
##............................#########..............##.......#############
##....##....................############............####.....##############
##.....##................###############...........######...###############
##.....##...............################.........##########################
##........................##.....#######.........#############...##########
##................................######........##..#########....#######.##
##................................######.......##....########.....#########
##................................######......###....#########...##########
##................................######......####..#####...###..##########
##...............................#######......##########.....##..##########
##.........#..........####......#########.....##########..........#########
##........####.......####........########......#########..........######.##
##.........####......###...........#######.....#########..........#####..##
##...........##......................#####.....#########..........#####..##
##.............#......................#####...###########.........#####..##
##.....................................#####.############..........########
##..###......................#.........##################...........#######
##.###......................####........##################...........######
##.###.....#...............####.........###################...........#####
##.##......#..............#####.........#########.......###...........#####
##.#.......##.....##.....######........#########.........###...........####
##...............###############......######..............#####........####
##.........#.....################....######...............######........###
##...............###....###################...............#######........##
##...............##......##################..............########........##
##..............###......#################............###....##..#.......##
##..............###......#######.....#####............##.................##
##..............###.....#######..........................................##
##..............####...########..........................................##
##.............################..........................................##
##...............#############................................###......####
##................###########..................................############
##.................#########..............#####................############
##.................####.###..............#######...............############
##.................########.............########.............##############
##.................#######..........###########........#########.......####
##.................######...........###########........########.........###
##..................#####.............########.........#######..........###
##..................#####..#.............#####.........#######.........####
##..................#####.................###...........######......#######
###.................#####.......####......###...........#######....########
####................####........#####....###.............##################
########............####.......######....###.............##################
##########...........#.........#####....###...............#################
##########.....................#####....###................################
##########....................######....###.................###############
##########...................########...####.................##############
###########.......#.........##########.######................##############
#############....#.........#####################.............##############
##################........#####################......####...###############
##################.......######.##############......#######################
##############..##.......####################......########################
##################.......####################.......#######################
##.###############......#####################........######################
###################.....######################.......######################
####################....#######################.....#######################
###########################################################################
###########################################################################
