###########################################################################
###########################################################################
####....###############################....################################
####....###############################....################################
####....################################..##########################..#####
#####..#########################################...###############.....####
###############################################.....#####..######......####
################################################....####....#####......####
##############...################################..#####.....#####....#####
#############.....######################################.....######..######
#############.....#######################################...###############
##############....#########################################################
###############...#########################################################
################.##########################################################
###########################################################################
###########################################################################
###########################################################################
###########################################################################
#########################################....##############################
########################################.......############################
###############################...######........###########################
###############################....#####........##############..###########
################################..#######.......#######..####....##########
############################################...#######....##......#########
#################################################..##.....##.........######
#########################################..#####..........###.......#######
########################################....####.........#####....#########
#######################################.....####........#######..##########
########################################...######......####################
####################################################..#####################
###################..######################################################
#################.....#####################################################
########..............#####..#############################..###############
#######...............####....###########################....##############
######................####....############################...##############
#####..................##....#####...#####################....#############
#####...........#..........######....######################.....###########
######.........###........#######....######################......##########
#######.......#####.....##########..######################.......##########
########......#####....##################################........##########
########.......#####..##################################.........##########
########.......#########################################.........##########
#######.........########################################.........##########
######..........###########..############################.......######..###
#####............#########...########################################....##
#####................####....########################################....##
#####.................###....#########################################..###
#####.................####..#################################.#############
####..................#####################################################
###....................##########...#######################################
###....##..................##........######################################
####..##########.....................######################################
######################..............#######################################
#########################........#################.########################
##########################...####################.#########################
###########################.###############################################
###########################################################################
###########################################################################
###########################################################################
###########################################################################
###########################################################..##############
##########################################################....#############
##########################################################....########..###
###################################..#####################....#######....##
##################################....#####################..######......##
##################################....############################.......##
##################################.....##########################.......###
#################################..........#####################.......####
##############################..............####################......#####
#########..##################...............####################......#####
########....#################...............#####################.....#####
########....##################......###.....######################....#####
#########..####################...#######..########################..######
###########################################################################
###########################################################################
