###########################################################################
###########################################################################
###############################............################################
###############################............################################
##############.............####............################################
#############...............###............################################
############................###.............###############################
###########................#................#....##########################
##########................................#..........###########..#########
#########.............................................#####........########
########...........................................................########
#######...........................................................#########
#######.........##..............................#................##########
#######.........###.............................................###########
######..........##.............#............................###############
#####..........##..............###.........................################
####...........#..............#######......................################
####.........................###########...#...................############
###..........................############..............................####
##...........................###########...............................####
##............................#########....................#...........####
##...............................######...............................#####
##................................######.............................######
##................................#######...........................#######
##...............................########.........................#########
###..######.....................##########......................####..#####
############..................############..............#.....#####....####
######...####...................###########........##..........###......###
#####.....####....................##########.....#####...........#......###
#####......#####...................##########...######..................###
######......###.....................##################..................###
#######.....###......................#################............#.....###
##..####..............................##..############..................###
##...####..........#..................#....############.................###
##....####........###........................##############.............###
##.....####......####.........................###############...........###
##.....#############...........................#############...........####
##......###########...................................######..........#####
##......###########............#.......................#####.........######
##......##########...........#####...#..................####.........######
##.......#########...........###########..........#.....###.............###
##........########...........#############...............................##
##........##...#######.......##############.......##.....................##
##..............#######......####....#####.......##......................##
###..............######......###......####....##.........................##
##................#####......##.......###.....##.........................##
##.......#........#####......#.......###.......#...........#....#####....##
##.................####...............#....................################
##.................####....#..........#...................#################
##......#...........####..###.............................#################
##...................########......#......................#################
##......................######............................#################
##........................#####............................################
##.........................####......................#.....################
##..............#...........###............................################
##...........................##............................################
##...........................##............................################
#########....................##............#...........#..#################
##########...................##..........###...........####################
##########.......#..........###...........###..........####################
##########..................###............##..........####################
##########..................##.............##.........#####################
###########................................##........######################
###########................................###.......######################
###########...............................###.......#######################
##########...............................####.......#######################
###########.............................#####.......#..#############.######
###########.....###...............###########..........############...#####
####################.............#############........#####################
####################..........#################......######################
#####################.....#################################################
###########################################################################
###########################################################################
###########################################################################
###########################################################################
