###########################################################################
###########################################################################
##......................................##..........#....######..##########
##.........................................#.......############..##########
##.................................................############..##########
##.................................................########################
##.................................................########################
##..............#...................................#...###################
##..............#.......................................###################
##..................................................#...###################
##......................................................###################
##.#................................................#...###################
####................#...............#....................##################
##......#...........##...................................##################
##.................##.....................................#################
##................###.....................................#################
####.............####.....................................#################
####.............###......................................#################
###........................................................################
##.........................................................################
##............................................................#############
##.........#..................................................#############
##............................................................#############
##....................................#........................############
##.....................##............###............................#######
##.....................##...........#####..............................####
##.######..............#...............................................####
##..##########...............#............#............................####
##..#####..###..............##.................#................#.....#####
##..#####..###..............##.......................................######
##...########..............##........................................######
##....######............#####........................................######
##......###..............##.........................................#######
##.................................................................########
##.................................................................########
##.................................................................########
##.........................................#........................#######
##..................................................................#######
##..................................................................#######
##.....###..#......#...............................#................#######
##...#####.#............#..........#................................#######
##.######................##........#................................#######
##..####................###.........................................#######
###..###................##.........................................########
###..##...........#.....##.................###....................#########
######..................##...............#####....................#########
######...............#..##...............##......................##########
######....#..............#.......................................##########
#####...................................##......................###########
#####..................................###.....................############
#####.................................####.....................############
#####..........#........................######.#..............#############
#####....................................######...............#############
#####........................................................##############
#####..................####..................................##############
#####................######.................................###############
######................######................................###############
#######................#####................................###############
########.......#........###................................################
############..###........##......#.#......#................################
################.................#.........................################
#########..#####...........................................################
#########...##...........#................................#################
#########...##..........#.................................#################
#########...##............................................#################
##########..##..........#.................................#################
###############...........................................#################
################..........................................#################
#################...................................##....#################
###################..................#.............####...#################
####################...............####......##############################
#####################.............######.....##############################
######################...........#######....#####..########################
###########################################################################
###########################################################################
