######################################################################################################################################################
######################################################################################################################################################
#######################.................#################...................########################################......#........###################
#########..#############.................################....................######################################...............#######....#########
#######....##############................###############.............#.......####################################.................######......########
######.....##############................###############.............##......####################################.................######.......#######
######.....##############...............###############..............###....####################################...................#####.......#######
######....################.......######################..............####..#####################################...................#####.......#######
#######..##################.......#####################..............###############################...#######.....................#####.......#######
############################.......####################.............###############################.....####.......................####........#######
#############################.......###################.....###....###############################......###.........................#..........#######
##############################......###################.....######################################............................................########
#####..########################.....####################...#######################################...........................................#########
####....#########################..###############################################################......#...................................##########
###......##########################################################################################....##...................................##########
##.......###########################################################################################...###..................................##########
##......###################################################################################################..................................#########
##.....######################################################################################################................................#########
##...#########################################################################################################............####................########
##...####################################################################################.....###############.............#####...............########
##...#################################################################################.........##############..............#######............########
##...#####################################################..#########################...........############...............#########..........########
##...####################################################....########################............##########................##########.........########
##..#####################################################....########################.............########.....#...........###########........########
##..############....##################.......#############..########....#############..............#######..................###########.......########
##.############......###########...............####################......############..............#######..................############.....#########
##..###########.......######....................##################.......###########................#######........#.........#############....########
##...##########........###......................################.........###########.................#######.....###.........#############......######
##....#########.................................###############..........###########.................###############..........##########..........####
##.....########.................................##############...........###########.......#..........##############..........#########............###
##........#####.................................##########...............###########......###.........###############........#########.............###
##.........#####...............................########.............#....############...######........################....###########.............####
##...........##...............................#######...............##..#######################.......##############################..............####
##..........................................########................###########################.......##############################..............####
###........................................#######..................###########################.......####......####################..............####
###......................................######......................#########################...................###################..............####
####...................................#######.......................#########################....................###################.............####
#####..................................######.........................########################.....................#####################.........#####
######.......#........................#######.........................#######################.......................####################........######
#######.........#....##...............########.........................######################.......................####################.......#######
########........########..............#########.........................#####################......................######################......#######
#########.......########........##...###########........................#####################.....................#######################.....########
##########......#########.......#################..................#....######################.................###########################...#########
#####...........#########.......#######....########................##...#######################..............#######......#################..#########
####.......##...#########...................########..............####.#########################...........########........###########################
####......####.###########..................###################....##############################.........####..............##########################
#####..###################..................####################...###################################....###...............##########################
###########################.................####################....####################################.###................##########################
###########################.................####################......#####################################.................##########################
############################................#####################......####################################.................##########################
###########################................######################.......###################....###########.................###########################
###########################...............#######################.......##################.....##########.................############################
###########################............##########################.......#################......#########.................#############################
##########################.........##############################......##################.....#########................###############################
##########################........###############################.....####################..##########........#......#################################
############........#####........####################...#########.....#########..####################........###....#####.....########################
###########..........####.......###################......########......#######....#################..........###########........######################
###########............#........####...........###.......########........####.....################...........###########..........####################
############...................####......................########..........#.....################............###########...........###################
################..............#####......................########................###############.............############..........###################
################.............######.....................#########...............############.............#...############............#################
#################...........######.....................##########...............###########.............#################....................#########
##.##########...............#####..............###################..............##########..............##################....................########
##...#######...............#####..............#####################............##########...............##################.....................#######
##..######................######............############################################...............###################......................######
#########................#######...........#############################################..............####################......................######
########................########..........#############################################..............####################.......................######
#######............##############........#############################################..............########..##########........................######
#######...........################......###############################################...#################....########.........................######
########.....####..###########################################.############################################....########.........................######
#################...##################################################################################..###....########.........................######
#################...###############################....##############################################....###...########.........................######
#################...##############################......############################.......##########....###...########......##.................######
##################.........#######################......###########################.........##########..####...########......####...............######
#################...........######################......##########################..........###############...#########.......####.........#...#######
#######.....#####.............####################......#######..#################.........################...##########.......####..........#########
######.......####..............###################......######....#################........#################..###########......####..........#########
#######........#.........................##########....######......####......#######......################################....#####...........########
#######...................................###################......###.........#####......########################################.............#######
#######...................................###################...................#####....#########################################..............######
#####............................##.......####################...................#####...##########################################..............#####
####...........................#####......##################..#...................#####...##########################################.............#####
####.....................###..########...###############...........................###....########################...##################.........######
####....................###############################.............................###...#######################.....###################......#######
####...................###############################..............................###..########################......###############################
#####..............###################################...........##.................#############################......###############################
######............#####################################...##########...............#########......################.....###############################
#########.........####################################################....#.....##########.........###################################################
###########......#######.........########################################################...........##################################################
#######################...........######################################################............##################################################
#######################...........################################...##################.............##################################################
######################............###############################.....#################.............##################################################
######################...........###################....#######.......##################............##################################################
######################..........##################.......###..........###################..........#####################..############################
#####################..........#################..........#...........#####################.......#####################....###########################
#####################.............#############........................################################################....###########################
#####################..............###########..........................################################################..############################
#####################...............##########...........................#############################################################################
##.#################................##########............................############################################################################
##..#############........###........#######....................................#######################################################################
##..###########..........####.......######......................................#####...##############################################################
##...###..................####.....######........................................###.....#############################################################
##....#.....................############............................#.............##.....#############################################################
##...........................###########...............................##.........###...#########.....################################################
##............................##########......#..#................................##############.......###############################################
##.............................#########......................##..................############.........###############################################
##..............................########......................###.................##########...........###############################################
##...............................#######.....................#####...............##########............###############################################
##....................##.........#######.....................######.............##########.............###############################################
##......#####......#######.......########....................########..........###########.............##############################......###########
##.....########...#########......##########..................#############################..............############################........##########
##.....##############..#####....############.........#.......#############################...............#...........##############.........##########
##....##############....##############.......................##############################...........................#############........###########
##.....#############....#############........................#####..########################...........................############......#############
##.....##############..##############..................#......###....########################..........................#############.....#############
##.....###############################.................#......##.....#########################.........................##############...##############
##.....################################.................#......#....###########################........................###############################
##.....#################################...........................#################################....................##############################
##....#############################..####.....##..................####################################...................#############################
##..##############################....##########.................######################################...................############################
##############....###############......##########...............##########################################.................###########################
#############......#############.......###########..............#########################################.......###...........########################
############.......############........#############...........##########################################.......###......#.....#######################
###########.........##########........###############.........###########################################.......####...........#######......##########
###########...........######........##################.......###########################################.........###...#.......######...........######
##########.............####........####################......##########################################..........###..........#######............#####
#########...............###........#####################.........######################################...........#..........########............#####
#########...............###.......######################..........#####################################.....................##########...........#####
###..####...............###.......######################..........#####################################.....................##########...........#####
##....###...............###.......#######################.........#####################################.....................###########...........####
##.....##................##.......########################.........####################################.....................###########............###
##.....##.........................##########################........#############..####################......................###########...........###
##................................#########...#......#######.........###########....###################.......................##############......####
##...............................######.##............#####..........##########.....################........####...............##############....#####
##..............................######.................................#######......###############.........####...............#######################
##.............................#######..................................######......###############.........#####..............#######################
##..............................######...................................#####......###############........########............#######################
##...............................#####...................................######....################........#########...........#######################
##..............#................#####..................................###########################.......##########...........#######################
##..............#................######................................############################.......##########...........#######################
##..............##...............#######..............................#############################.......###########..........#######################
##.....##..............##........########................#...####....###############################....#.############.........#######################
##.....#####...........###......################........###.###########################################################........#######################
##.....######..........#############################...#################################################################......########################
##....#########.......###################################################################################################....#########################
######################################################################################################################################################
######################################################################################################################################################
######################################################################################################################################################
######################################################################################################################################################
######################################################################################################################################################
