###########################################################################
###########################################################################
##..................#...##.......#########...........######################
##..........#....................########..........########################
##.........###....................#######...........#######################
##..........##....................#####.............#########..############
##...........#.....................#.....................####..############
##...........#...........................................##################
##.....................................#.................##################
##.......................................................##################
##.....#.................................................##################
##.......................................................##################
##.....#..............................................############..#######
##...#................................................############..#######
##.....................................................#..#################
##.........................#...............................################
##........................................#................################
##..................###..................#####.............################
##.................####..................######...........#################
##.................#####.................#######..........#################
##.................#......................#######.........#################
##...............#.........................#####..........####..###########
##........................................................####..###########
##........................................................#################
##........................................................##..#############
##.......................................................###...############
##.......................................................##.....###########
##................................................#..................######
##.............#.................................###..................#####
##.........#######...............................###..................#####
##..........#######........................#....#####.................#####
##...........#####..............................#####.................#####
##............###....................................#................#####
##.............#.....................................................######
##...................................................................######
####................................................................#######
#######.........................................#...................#######
#########..........................#........#.......................#######
##########....##........##..........................................#######
#########....###.......####.........................................#######
########....####......#####.........................................#######
######......#####......#####........................................##..###
#####.......#####......#####.........................###............##..###
####...................######....#..................#####...........#######
####....................#####.....................#######..........########
####.....................####......................#######.....############
####.....................####........................######...#############
#####.....................###...........................###...#############
######....................###............................##..##############
#######...................####............................#################
#######...................####............#...............#################
#######....................###............................#################
#######.....................###...........................#################
###..........................###..........................#################
##...........................###.........................##################
##..........................####........................###################
##.........................#####........................###################
##........................#######...........................###############
##........................#....#.............#................#############
##.........................................#..................#############
##...............#........................#...................#############
##............................................................#############
###...........................................................#############
####...............##........................................##############
#####..............###......................................###############
###########.................................................###############
#############...............................................###############
#############.......##......................................###############
##############......###....................................################
##.#####################.........#.............#####......#################
##.#######################......###########################################
###########################....############################################
###########################################################################
###########################################################################
###########################################################################
