###########################################################################
###########################################################################
############################.............##################.###############
##############..........####............###################################
#############............###.............##################################
############.............................##################################
###########..............................###################....###########
##########...............................##################........########
#########............................#..##################..........#######
########.............................#####################...........######
#####................................#####.....#######................#####
##............#..##..................####........#.....................####
##..............####...........#.....###................................###
##...............###..........###....##.................................###
##................###........#####..###.................................###
##.................##.......###########.................................###
##......#..........##......#############................................###
##....####.........###....###############..............................####
##.....###..........###..################.............................#####
##.....####.........#####################.............................#####
##.....###..........#####################...............###...........#####
##.....##............####################...............###..........######
##.....##..................##############...............###.........#######
##.....#.......................##########..............###..........#######
##..............................#########..............###.........########
##..............................#########.............####........#########
##...............#................#######............#####.......##########
##......###........................#######...........#####.....############
##......####......#.................######.......##.######....####....#####
###.....#####........................######.....##########...###.......####
##.........###........................####################..............###
##..........##.........................###################..............###
##......#....##.........................##############.####.............###
##..#####....####........................###################...........####
##.######....####........................####################.........#####
##..#####...#####.........##............#####################........######
##.....##########.........####...........####.....############.......######
##......#############......####..........###.......##########.......#######
##.......#############.....#####........####..........#######........######
##.........###########.....######......#####............####.........######
##............#########....##################..........................####
##.............#######......#################...........................###
##..............######......#######..#######.............................##
##..............#####.......######....######.............................##
##..............####.......#######.....#####.............................##
##..............####.......#######.......................................##
##..............####.......#######.............................####......##
##.............#####.......######.............................######.....##
##..............####......#####..............................########....##
##..............#####....#####..............................#########....##
##...............#####..#####...............................#########....##
##................###########..............#...............##########....##
##................##########...............##..............##########....##
##................#######.................###..............##########....##
##.................#####..................###.............###########....##
##...................####.................###............############...###
##....................###.................##..........#..###########...####
##.....................#...........#......##.........######################
##.####...................................##..........#####################
########.................................###...........####################
##########...............................###...........####################
############.............................###.............##################
#############............................####.............####.############
############............................######.............################
############..........................##########.#..........###############
############................###......###########............###############
#############...........######################.............################
###############........######################.............#################
##################.....#####################..........#####################
##################.....#######################.......######################
###################...######...############################################
###########################.....###########################################
###########################.....###########################################
###########################################################################
###########################################################################
