###########################################################################
###########################################################################
############################################.......#.......###########...##
###########################################.......###......###########...##
#################################..#######.......#####......##########...##
######...#######################....######......#######......#########...##
#####.....######################....######.....#########.....#########...##
#####.....######################....######.....##########....#########...##
######...########################..######.....###########....#########...##
#########################################....############....########....##
#########################################....#############...########....##
########################....##############..##########################..###
#####################.........#############################################
####################...........############################################
####################...........############################################
#########################.......###########################################
##########################......###########################################
############################.....##########################################
####################.########....##########################################
##############################..###########################################
###########################################################################
#################################################################....######
###########################################...##################.......####
##########################################.....###############..........###
##########################################.....############..............##
######################..##################.....###########...............##
#####################....##################....#####..####..............###
#####################....#####.################........###............#####
#####################.....#####################.........##.......##..######
#####################.....####################..........###.....###########
#####################.....####################.........#####...############
####################.....######################..###..#####################
###################.....#################..################################
################.......##################...############..########..#######
######....#####.......#################################....######.....#####
#####......####.......#################################....######.....#####
####.......####........#################################...######.....#####
####........###.........########################################......#####
####.........##.........########################################.....######
###............#####....#########################################...#######
###............######..##########################################...#######
###............######..####################################################
###............#####....###################################################
####...........#####......#######################..########################
######........######...........##########..#####....#######################
#######......######.............########....####....#######################
#######.....######..............########....#####..########################
#######.....#####...............#########....##############################
#######......####...............##########....#############################
########......####..............##########....##########################.##
########.......###....##.........#########....#############################
########.......###...#######.......#######....#############################
#######.............#########.......######....#############################
#######.............##########......######....#############################
#######.............##########......#####....##############################
########....##.....###########......#####....##############################
###############...############......######...####..########################
##############....#############....#######....##....#######################
##############....########################....##....#######################
##############....########################....###..########################
###############..##########################...###############..############
###########################################...#############.....###########
###########################################...############.......##########
####################################..######.#############.......##########
###################################....###################.......##########
###################################....###################.......##########
####################################..####################.......##########
##########################...##############################.....###########
#########################.....#############################################
########################......#############################################
#########################......####################################..######
##########################......##################################....#####
###########################.....##################################....#####
###########################################################################
###########################################################################
