###########################################################################
###########################################################################
##....######...........###.......#......#############.........###.....#####
###...#######........####........##.....##############.........#.....######
#############.......#####........###...###################..........#######
##############.........#........##########################...........######
###############.................##########...##############...........#####
################.................#####........######...#####..........#####
#################..................##..........####.....#####.........#####
################...............................###.......####..........####
#######....####.................................##.........#...........####
######......##..............#....................................##....####
##..........#....................................................##...#####
##..........#....................................................###.######
##.........###...................................................##########
##..........####..................................................#########
##...........####...................................................#######
##............#####..................................................######
##............########............#####...............................#####
##.............###########.......######................................####
##...............#########......########.............##................####
##................########.....##########............####...........#######
##.................########...###########............######......##########
##......................##################..........#########...###########
##.......................#################..........#######################
##.........#..............###############.......#..########################
##........#...............###############.........#########################
##.......##................##############.........#########################
##.......##.................##############.........####.....###############
##................................#########..........................######
###.....#...........................#########.........................#####
##......................##...........########...........................###
##..............#......####..........#########...........................##
##..................##########......#########........###......##.........##
##..................########################.....#..####.....##..........##
##..................#######################........#####....##...........##
##.................#####################...........####....###...........##
##................#####################............####...####...........##
##................#####################..............#######............###
##................#####################...............#####.........#..####
##................###############..#####..............####........#########
##................##############....#####.........................#########
##................#############......####.........................#########
##................############.......#####.........................########
##................###########.........#####........................########
##................###########.........####.........................########
##...............############..........#............................#######
##................###########........................................######
##................###########....................................#.#.....##
##.....................######............................................##
##.......#.#............#................................................##
##......###..............................########........................##
##...#####...............................#########.......................##
##...#####...............................##########......................##
##...####................................##########......................##
##...###................................############..........##.....######
##..####.................................##########..........##############
##.####..................................#########........#################
######.......#.......############.........#######........##################
######......#........#############.........######.........#################
######................############...........###..........#################
#####...................###########............#..........#################
#####.....................##########.....##...............#################
#####......................##.#############...............#################
#####.....................################......#.........###....##########
######................####################.................#......#####..##
#######................##################.........................####...##
########................################..........................###....##
#########...............###############..............#............###....##
##########.............################.............####...###...####...###
##############........#################............###################.####
##############.......###################..........#########################
###############.....#####################........##########################
###########################################################################
###########################################################################
