###########################################################################
###########################################################################
##......#####################################.......##....#################
##......#####################################.............#################
###....#####################################...............################
###.##############################.#########.................##############
###.##############################..#########..###............#############
###.##############################...########.#####..###......#############
###.#############################....########.###########....##############
###.##########################................#############################
###.#########################.....########....#############################
###.########################.....#########.....############################
###.###################..........##########.....###########################
###.##################...........###########....###########################
###.##################..........#############..############################
###.##################..........###########################################
###.##################.####.....###########################################
###.##################.#####.....##########################################
###.##################.######.....#########################################
###.##################.######.....#########################################
###.##################.#######...###################################....###
##..##################.#########.#################....#############......##
##..##################.#########.################......############......##
##..##################.#########.############.........############.......##
##..##################.#########.###########.........############........##
##..##################.#########.###########........#########............##
##...#################...#######..#########.............................###
##....################....#####....#######............######..........#####
##....################....#####........##..............######........######
##....################...#######..####..................#####.........#####
##.....###############.###############..................#####.........#####
##.......#############.###############..................######........#####
##........############.################..................######.......#####
##........########.....####################...###........#########....#####
##...................#######################.#####......###########..######
##..........#####....#######################.#######...####################
##...........#####..########################.#..###########################
##...........###############################.....##########################
###.........#################################....##########################
####........#################################...###########################
#####........################################..############################
######.......###############################...############################
######.......###############################...############################
#######......###############################...############################
########.....##############################....############################
##..####.....###############...###########.....############################
##...##......##############.....#########......############################
##...........##########..........########.....#############################
##...........#########...........#########...##############################
##...........#########............##########.##############################
####.........########..............#########.##############################
####..........#####........###.....#########.###################.##########
####............#.........#####....#########.###################.##########
#####........##..........######....#########.###################.##########
#######.....###..........######....#########.###################.##########
########....###..........######....#########.###################.##########
#########....##........##...####..##########.###################.##########
#########....##.....#####....###############.###################.##########
#######......##....######....###############.###################.##########
#######.##..##.....#######..################.###################.##########
#######.######....#########.################..##################.##########
#######.######...##########.###############....#################.##########
#######.#####....##########.###############....#################.##########
#######.#####....##########.###############....#################.##########
#######.######..###########.################..##############.....##########
#######.###################.#################.#############...#############
#######.###################.#################.#############...######.######
#######.###################.#################.####....................#####
#######...#################.##..#############........######....####..######
#######....################.#....################....#######..#############
########..#################......#################..#######################
############################.....##########################################
############################.....##########################################
###########################################################################
###########################################################################
