####################################################################################################
####################################################################################################
##################################......#########################....####....####.........##########
##.##########..##################....###########.######..............####.................##########
##..#.######...####....##########....#################................###..................#########
##..########....##......###.#####....##..############...........##.....###.....####........#########
##.######..................#######........###########...........##.....###....#########....#########
########...................##########.....#######..##.......####.......###....##########..###.######
#######...................############....######............###.......####....##############..######
######....................############....##...............####.....####.........###################
######........##..........###########......................####....####...........##################
########.....#####.........#####..##......................#####...#####....###....##################
##################.........####.........####.............###......####.....###.......##########...##
#################......##..####.........####.....#####...##.......####.....####.........####......##
################.......#######.........#####...#######..###........###.....####..........##.......##
######..########......#######.......#.#####....########..##........###....###............##.......##
##..#....#######......######......#########.....#######..#....#....###....##......##......#....#####
##.......####........#######......#########......#####......#####..##.....##......###......#########
##.......###........#########.......########.....#####......#####..##......##......##......#########
##......####........###########......########...######......###....##......##.......##..##....######
##....#####.........###########......#########.#######......##.....##.....###.......######.....#####
##....#####........#############........#####...#####.......##.....###....##........######.....#####
##....#####.....################.........###.....####.......##....####....##........#######...######
##....#####...##################..........##.....####....###....#####.....##........################
##.....#####..###########..#####...........##....####....###....#####...............################
##.....####.....########....####...........######..##....###....#####..................#############
##....####.......#####......####...........######........##.....######.....#............############
##..######........###.........##..............###.......##.....#######.....##............###########
##..####...........##..........##..####..............#######..#######......##.......##....##########
##.................##....##....#########.............################..............###....##########
##......................###...############......##.....#############...............###.....#########
##............##.......#####.#############......####....##########.................###.....#########
##............##....###########..#########.....#####....###########...............####.....#########
##............##....##########....#########..#######...###############.............###.....#########
##............##....####..####.....#############.###..################.............###.....#########
##....####................####.....###################################............##.......#########
##...#####...............######...#####################..##############..##......##........#########
##.########...#.......##########..###############..####...#############..##.................########
################......###########.##############....###....#############.....................#######
################..........######################....###....##############....................#######
################..........#######################..####...####....########...................#######
################..........######.......###..###########...###......#######...............###########
#################........######.........##...##########............#######....###........###########
##.##############........#####..........##...##########............#######...####....##.....########
##..#############....###..####...........##########.......................#######....##......#######
##..#############..#####..####..........###########.......................#######....###......######
##.....#..##.....######..#####.......############.#........................#######...####........###
##...............#####...######.....################..........##............##############.......###
##...............#####...###############################......##....##......################.....###
##...............####.....######..########################....###..###......#################...####
##..............####......#####.....#################.####....#######......###########..############
##............#####........###.........#############.........#########....###########....#...#######
##...###.....######........###...###....###########.......###########################.........######
##...###############.......##....###....##########........############################...#.....#####
##..##################....###....####..###########.......##################################....#####
####################################################################################################
####################################################################################################