###########################################################################################################################################################################################################################################
###########################################################################################################################################################################################################################################
#######......####.........####...###.........#######.........############################################################################...###########......##############.....###########################################################
######........##..........####...............#######.........###################################################################################..#####......#############......###########################################################
####..........#...........####...............#######.........#############################.######################################....########......####.......############......###########################################################
##........................####...............###.............############################...####################################......######......#####.......############.....############################################################
##.......................#####..............###..............############################...###################################.......#####.......#####......##############...###########..######################################....######
##.......................#####..............###..............##################################################################.......####.........#........############################....####################################......#####
##......................######.............#####............###################################################################.......###...................############################.....#################################........#####
##......................######.............######.........####################################################################........###...................###########################.......###############################.........#####
##......................######.............#########....#####################################################...##############........###......................########################.........############################..........#####
##.....................########..........####################################################################....#############........###.......................#######################...........#########################...........#####
##....................##########.......#####################################################################.....#############........####......................#######################............#######################...........######
##.................################...####################################################################.......#############........#####......................######################.............#####################...........#######
##................#######################################################################################.........###########........######......................#####################................##################...........########
##.................#####################################################################################..........###########.......########.....................########..###########...................###############..........#########
####...............##########################################################..########################............##########......#########.....................#######..###########.........#.............############........###########
####...............#########################################################....######################.............##########.....##########..........##.........####################........................###########......#############
##..................########################....###########################.......####################..............########.....############.........##........#####################.........................##########.....##############
##..................#######################......##########################............###############..............#######.......############........##.......######################.........................##########....###############
##............#......#####################.......##########################.............##############..............######.......#........########...##.......########################......##................###########..################
##............##.........################........#############........####..............##############..............#####..................############.......#########################....#####..............#############################
##............###.........######..#######........###########...........###..............###############.............####...................###########.......###########################..########...........##############################
##............###.........####.....######........######.................#...............################............####...................###########.......#######################################.....##################################
##...........#####........###.......######.......#####..................................##################..........####...................##########........########################################..####################################
##.........######.........###.......######......#####..................................####################........####...................##########.........##############################################################################
##.........######.........###......######.........##...............#....................##################........#####..................###########........###############################################################################
##.........#####..........##############.................................................################........######..........###################.......###################...##########################################################
##........######..........#############......#...........................................###############.........######........#####################.....####################.....#########################################################
##........######..........####....#####.....##.................................######....###############.........#####.......########################...#####################.....#########################################################
##........#######........####......####.........................#............#########..################.........####.......##################################################...##########################################################
###...........###........####.......###.....................................#############################........###......#################################################################################################################
###............##........####.......###..................................################################........###....##################...#######################################################################....###################
###.....................######......####................................###############################..........####..##################.....#####################################################################........####....########
####.............##....######......######..............................#############################.............########################.....####################################################################..................#######
#####............###..#######........#####............................#############...#############...............#######################.....#####################################....##########################....................######
############.....############..........########......................#############......#########..................#######################...#####################################......#########################....................######
#############....############...........#######..................################........#######...................###################################.....#######################.......#######################............#........######
##############..##############............####...................################.........#####....................##################################.........####################.......#######################............#........######
###############################..................................#################.........###....................#################....#############..............#################.......#####################.....................#######
##....##########################.................................##################.........#.....................################......############...............###############.........#################.##....................########
##.....##########################................................##################.........#.....................###############........###########.................#############..........###########.....###...................#########
##......##########################...............................###################................................#############........###########..................############...........########.......###..................##########
##......############################...............#.............###################..........#....###...............############........############.................#############...........######........####.........##.....###########
##.......########.###################..........##...............#####################............######...............###########........###########..................##############..........#####........######........##################
##........############################.......#####..............#########################........#######..............###########........##########..................################.........#####........#######.......##################
##........#############################.....#######...........############################......########.....#........############.......#########...........###....##################.......######........########......##################
##........#############################....########..........##############################.....########.....#........#############.....##########........#######..###############################.........#######.......##################
##........##############################..##########........################################...########.....#.........############################.......#########################################.........#######.......##################
##........############################################################################################......#........############################.......##########################################........########.......##################
##.........############################################################################################....###..#################################.......##########################################.......##########......##################
##.........#############################################################################################..#######################################.......##########################################.....##############...###################
##...#.....######################################################################################################################################......###########################################....#####################################
##.........#######################################################################################################################################...##############################################..###################################.##
##..###...#################################################################################################################################################################################################################################
###########################################################################################################################################################################################################################################
###########################################################################################################################################################################################################################################
