###########################################################################################################################################################################################################################################
###########################################################################################################################################################################################################################################
#######.................##############################...##################################################################........####..........####.....############.........############################################################
######..................########################.#####....##################################################################.......###...........####....#############.........###################################################.########
######..................##############################.....################################################################.........#.............####..###############.......###################################################...#######
######.................###############################.....################################################################........................#####################.....###################################################....#######
#####...................##############################.....###############################################################..........................############################################################################....#######
##......................#######...####################.....###############################################################.......#...................#...################################...####################################....#######
##......................######.....####################...################################################################................................##############################.....####################################..########
##......................######.....#######################################################################################.................................############################................####################################
##............####.....#######.....#######################################################################################.................................###########################..................###################...#############
##............#################...#########################################################################################...#######......................##########################....................#################.....############
##............##########################################################################################################################...................##########################.....................################......###########
##...............#########################################################################################.....###########################.........###..........####################.......................###############.......##########
##.................####################################################################################.........######################################...........###################........................##############.......##########
##..................##################################################################################...........#####################################...........##################..........................#############.......##########
##..................##################################################################################...........######################################..........##################...........................#############......##########
##...................#################################################################################...........#####################################.#.........###################............#.............##############....###########
##...................##########################..#####################################################...........###############.......##############............####################.......######............#############################
##....................#########################...######....##########################################...........#######................############............###################################..........##############################
##.......................#######################..#####............#########.....######################..........######..................##########............####################################..........##############################
##.#.....##########.......############################...............######.......#####################..........#####...................#########............######################################........###############################
###################........###############.....#######................####........######################........#####....................#########..........#########################################......################################
###################.........#############.......#######.................##........#######################.......####.....................#########.......##################################################################################
###################...........###########.......########.........................#########################......####....................##########.......####################...###########################################################
###################..............########........########.......................############################...#####...................###########......####################.....########################################..################
##......###########...............#######.........#######.................##########################################...........###################......####################.....#######################################....###############
##.......##########................#######................................############################..############..........#####################....######################...########################################....###############
##.......##########.................######...............................############################......#########.....##..############################################################################################..################
##.......##########..................#####...........................################################.......#########...###################################################################################################################
##.......###########..................####...........................###############################.........#####################################################################################################....#####################
##......##############.................###............................##############################.........####################################################################################################......#######...##########
##......##############..................##.............................############################...........###################################################################################################.......#####.....#########
####....###############.................##.............................###########################............########################.......####################################################################........####........######
#####..#################.................#......................#.....############################.............######################.........#########....######################################################........#####........#####
##########################.............#..................#########################..############..............#####################..........########......#####################################################........######.......#####
############################..............................########################....###########..............####################..........########........####################################################.......########......#####
############################..............................########################....###########.........#...####################..........########.........#########################.....######################........######........####
############################..............................########################.....##########........########################...........######...........###..##################........##################........#....###.........####
#############################............................#########################......##########....########..################............#####...........###....################..........################...............##........#####
##############################............................########################......##########.......####....###############...........######............#......##############............###############...............##.......######
###############################...........................#########################......##########.......#......###############..........#######...................##############............################..............###.....#######
######....######################...........................########################.......##....####..............##############.........########...................##############............#################.............###############
#####......#######################...........................#######################.............##...............##############........#########...................###############...........##################...........################
#####.......######################............................#######################....##......##................##############......##########..................#################.........#####################........#################
#####.......#######################...........................##############################.....#..................##############....###########.................####################......###############################################
######......########################....#############.........#############################.....##.........#........#############################................######################....######..########################################
#####.......##########################################.......##############################....###........####.....##############################..........#....#################################...###.#############..####################
##..........###########################################.....###############################...####.......######...################################........#######################################..#################....###################
##..........###############################################################################..#####.......#########################################........#########################################################......##################
##..........######################################################################################......###########################################......##########################################################......##################
##.........########################################################################################....########################################...##....###########################################################......##################
##........#####################################################################################################################################...###..#############################################################....###################
##.......#######################################################################################################################################.##########################################################################################
##......###################################################################################################################################################################################################################################
###########################################################################################################################################################################################################################################
###########################################################################################################################################################################################################################################
