###########################################################################################################################################################################################################################################
###########################################################################################################################################################################################################################################
##...............................##############.........####################################################.......############..#######.............##################.###################################################################
##...............................##############.........###############....................#################......##############...######............################....##################################################################
##....................................#########...........#############.##################.#################.....##########...#.....######...........###############......########################....#####################################
#####..................................#########............###########.##################.#################.#############...........#####..........################......#######################......####...##################...########
#####..................................#########.............######..##.##################.#..##############.##############...........####..........###############.......#########..#####...####......###.....################....####.###
#####.................#.................########..............####....#.##################.....#############.###############...........####...........#############........########..####.....###.....###.......##############.....##....##
#####...................................#######.............#####.......##################......############.################............#.............############........########.#####......##...............#############............##
##............#....###......................##.............######.......####################....############.##############.............................###########............####.####.......##................############......###...##
##..##.............#####.....................#......###...#######.......#####################..#############.#######..####...............................###########............###.###........##.................##########........##...##
##..###...........#######..........................##############.......####################################.######....##.................................###########............##.##.............................#########........###..##
##..####........##########........................###############.......###########################...######.#####.....##..................................###########..............#.........#####.................######..........#######
##.#####........###########.......................#######....#####......##########################.......###.####......##...........................#.......#....#####...............#........######....###.........#####...........#######
#######.........############.........................###......#####.....##########################...........####....................................##..........#####.......................#######.########.......#####...........#######
######.........#################.#............................######....################..########...........####........#.....#....................###..........######.......................######.#######........######..........#######
#####........####################..............................#########...############....########..........####.........##........................###..........######.......................######.######.........###########....########
#####.......############....#####................................######.....###########....#########.#........###.........###.......................###.........########......................######...####........############.###########
#####.........########.......####.................................####......###########....##########.........###.........###.......................###........##########......................#####....###.......#############.###########
######.........###............###..................................##........##########.##############........####........###........#.............#####......###################..............#####....###......##############.###########
#######.##......#.............................................................#########.###############.......####........####...##...............######......###################............#.######..#####....###############.###########
#######.###....................................................................########.###############.......####........#########.............###.#####...#.###..###############..............#####################..########.###########
#######.######............................................................#.....#######.################......####.####..###########.................########.##....##############..............####################....#######.###########
#######.######...........#####.........................#..####...........#......#######.################......####.##################..........####.#########........#############..#...........##################......#######.###########
#######.#######......###.#####...........................#####.###########......#######.################......####.####################.......###################...###################.........########................######......#######
##...##.########....####.######...........................####.############.....#######....##############.....####.#####################.....###########################################........#####...................#####........######
##....#.################..#####.................#.........####.#############...########.....#############....#####.################.........############################################..........#.....................####.........######
##......#######################................##..........###.#######################......########.........#####.###############........##########........#############.....#########..................................###.........######
##......#####..################................###.........###.####..#################.......######..........#####.##############........##########..........###########.......####....#.............................................######
###.............################..............####.........###.###....###########..............###...........#####.######..######......############.............########.....................###......................................#####
##.....#####....#################..........#######.........###.###.....###########..##......................######.#####....######.#....###########...............######.....................###......................................#####
####...#####....##################........#########.......####.#...#.....############........................####..#####....#####...........#######..................###....................####......................................#####
###....#####....##############..##.........#.....#############...............########........................###....####....####.............######.....#...........####...#...............#####......................................#####
##....######....############.....##...............############....##..........######.................................###.....##................####......#.........#####..#..............#######.....................................######
##....######....###########.......................############....###.........######.........................####....###....#...................###.....#.........#####.................########.................#...................######
##....######......########.......###..............############....####................................#.......####..####...#.....................##....##..........##..................#########................###....................####
##....######.......#######......##########........#############..###################..................#.......###########........................#.....#...........#.......##...........########...............###.......................##
##....#####........########....##############.....########..########################.................###......############................................................##.............#######...............##........................##
##.....###........###########################......#####.....#######################.................###........##################........................................##.............#######.....#.....................######.#......##
##.....###........#######################....................###########...#########......##..........###........##################.......................................##.............######.....##....................#.########.#...##
##...............########################....................##########....##########.....####.........#..........##################.....................................####...............####...####......................#######.######
##..............########################.....................#########.....##########.....####.....................#################...................................########..............###########......................######.######
##.............######################........................########.....#.#########....#####.....................#################..................................#########..............###########......................######...####
##...........#######################.........................#######........##################.....................##################..................................#######...............##########.......................######....###
###.........#######################.........................................###################....................###################.................#####...........#######........#......#######.........................#######....###
###........#####################.............................######.........######...#####.......................#####################.....#...........#######........########...............########........................#######....###
####......#####################........##.##................#######.........#####......#........................######################....##..........#########.##############........#..#..#########.................#.....#########..####
####.....#####################.......####.###..............########........####.................................######################....###..........########.##############..............#########.................###..################
##......#####################.......#####.####.....#.......########.....######.................................#######################....###..........########......##########.............##########..............#####.#################
##.....######################......######.#####.....##....#########....#######.......................####.....########################....##...........########.......#########.............###########.............#######################
##.....#######################....#######.######...####..##########.....######......................######........###########............###...........########........########.#...........#############...........#######################
##.....##################################...########################....#######.....................#############.###########.#########.####..........#########........########.###.........################........#######################
##....##################################.....########################..###########.................##############...##########################.....#############.......########.####........###################.....#######################
##...###################################.....######################################................##############....##########################...################.....########.########...#####################...########################
##.#####################################....########################################...............##############....##############################################...#########.###########################################################
###########################################################################################################################################################################################################################################
###########################################################################################################################################################################################################################################
