###########################################################################################################################################################################################################################################
###########################################################################################################################################################################################################################################
##........#########........###................####............#########....######################.####################################......................##############.#......###############################################...#######
##.........######........####.................####............###########.############################################################.......................#############.......##########..##############################################
##.......................####..................###............###########################...#########################################......##................#############......##########....#############################################
##......................####...................###............#################...######.....#######################################.....#####.................##########......##########.....#############################################
##......................####...................###............################.....#####......####################################......#####...................##..#####.....###########.....#############################################
##......................###...................####............###############.......#####.....###################################......#####.......#..#..............#####...###########.....#####################################....#####
##......................##....................#####...........###############.......######...####################################......####..........###.............###################.....####################################......####
##......................##....................######..........################.....######.#.#####################################.....####..........................####################.....###################################........###
##.....................####..................########........###########################...#####################################......####.........................#####################.....##################################.........###
##....................######.................#########.....#############################...#####################################.....#####........................####...##############......#########################.#######..........###
##........#####......########..##...........#############################################.###################...################.....#####..............#........####......############.......###############################..........####
##........#########################.........################################################################.....###############.....#####.............##......#####........##########..............########################..........#####
##..........########################.......################################################################...........##########......#####............##.......####.........#########................#####################........########
##.............######################.....###############################################################..............########.......######...........##.......####..........########.................###################........#########
##..............############################################################...#########################...............#######........#######..........###......####..........########....................###############........##########
##................#########################################################......######################...............########.......#########.........###......####..........########.....................#############........###########
##.................#######################################################.............################..............#########.......##########........##.......#####........#########......................###########........############
##..................##############.##################.###################...............###############.............##########........##########......###.......######....#############...........#..........#########.........############
##........................#################....#########################.................##############.............#########..........##########....####......#########################......................########........#############
##..........................##############......#######################..................###############...........##########...........################......###########################......................#######........#############
##............................###########.......###################......................###############............########.............##############.......####################################.............#######.......##############
####...............#.................###........############.............................###############............########..............############.......######################################...........#########.....###############
#####...........................................###########..............................###############............#######...............###########........#####################################...........##############################
#####..........................................#########.................................###############............######...............###########........######################################..........###############################
#####......................#...................#########................................################...........######........##.....############.......#######################################.........################################
####............................................########.................................###############.........#######.........###...############.......######################..################........#################################
####..............................................#######.....................###........###############.........######.........###################......######################....################.......#################################
###.................................................######...................#######.....###############.........#####..........####################....#######################....###############........#################################
##........................##.........................###....................#########....###############.........#####.........################################################....##############........##################################
##...............#.....######..............................................###########..################............#.........#################################......###########..###############.......###################################
##.....................######............................................################################...................##########....####################........###########################.....############....###########...#######
##....................#######..........................................###################################.................##########......###################........############################...############......#########.....######
##....................########.........#..............................##################################..................##########........##################........##############..##########################........#######......######
##.........#..........#########........#........###..................##################################..................###########.........#################.......##############....#######################............####.......######
##........####........#########...............#####.................##############.........###########..................############..........#################.....###############....######################..............#.........######
##.############.......#########...............###...................#############...........#######.................################..........#####################################.....####################.........................######
###############.......##########....................................#############...........#####..................#################..........#####################################.....####################.........................######
##.#############......##########....................................##############.........#####.................####################........##########...#####......##############......##################..........................######
##....########........###########...................................###############.......#####..................###################.....#############................#############.......################...........................######
##.....######.........##############.................##.............################.....#####....................#################......#############................#############........###############..........................#######
##.....#####.........################..............................##################...#####......................################......#############................#############.........###############........................########
##......####........#########.#######.............................##########################........................###############......##############...............#############..........####################..................########
##.......####......##########.#######............#...............###########################.........................##############.....################.............##############..........#########..#########..................########
##.......###################.########..........####.............############################..........................#############.....#################...........################.........########....#######..................#########
##........############################.........####...........##############################........#..................############.....##################.........##################........#######........####.................##########
##........############################........#####...........##############################.......##..................############.....###################.......####################......########.........###................###########
##.........############################.......#####..........###############################......####................##############...######################....##################################..........###...............############
##.........#############################......#####........##################################....#####...............##############################...############################################..........####.............##############
##.........#############################......######....##############################################............################################.....###########################################.........#####...........################
##.........############################.......#########################################################.........#################################......###########################################........######..........#################
##........#############################......####################################################################################################.....############################################.......#######.....######################
##........#############################.....######################################################################################################...##############################################.....###################################
##.###...##############################....################################################################################################################################################################################################
###########################################################################################################################################################################################################################################
###########################################################################################################################################################################################################################################
