###########################################################################################################################################################################################################################################
###########################################################################################################################################################################################################################################
###########............###..#####............#######..............######................################.........########.......##########.....############.#######################################..#########################...........##
###########............##########............#######.............########..............##################.........########......#######.........###################################################...########################...........##
##########.............###########...........#######.............#########........#...####################.......#########......#####............###################################################..########################..........###
##.######..............#############........########............##########.......##########################......#########......####......#......################.........#####################################################...#....####
##..####................###############....##########..#.......############.....##########...###############....###########....####.....###.........#############..........#######################################..##########....#########
##...###................#################################.....########..###....###########...###############################..####......####..........#############.........####################################.....########.....#########
##....##...............###################################....#######....##...###################################################......####.........#..#############.........#################################........######.....##########
##....##........#....##########...########################....#######....##############################..####....################......####............##############.........######.########################.........######.....##########
##....#........###############......######################....########..##############################....##......######......###......####...........################........###########..#################.........#######.....##########
##...##........###############.......#####################...#########################################............#####........##.......###..........##################......###########.....##############.........########.....##########
##...#.........################......#################################################################..............#..........##........#............####...##########################..........#########.........#########.....##########
##..##........##################....####################################################..############.........................###....................#.......#########################...........########........###########...###########
##...#.......####################..##############################################..####....############.........................#..............................########################...........########........#########################
##..........#######################################....########.......##########....##.....############.................#.....................#................##########################.........########........#########################
##.........#######################################......######.........########.....##.....############................#..............#.....#####..............#########################.......############.......#########################
##..........#########################..###########......######.........#######......##......##########.....................................######.............##########################......##############.....################.#########
##...#......########################.....#########.......####.#.......########.....####........#######.................#..................########...........###########################.....#################..##################....#####
##.###......#######################......#########.......###..........########.....#####........######...................................########............##########################.....#########################...##########.....####
######......#######.....###########.....##########........###........#########.....######........#####...................................########............##########################.....########################.....##########...#####
######......######.......#################......###.......####........#.............######.......####...........##.......................########.............########################......#######################.......#################
######......######.........##############..........#......####......................#######........#..........####...........#...........#######.......#.......#######################....#########################........################
##..#.......#####.............##########..................####......................#######..................#####..........####.........#######......##.......#######################....#########################........################
##..........#####...............#######..................#####........#.............########................######.........######.........######....####......########################....########################.........################
##..........#####.................####.....#.........#########...................##########.#...............######........########........#######..######....#########################..#..#######################..........###############
##..........#####...................##...............#########...................##########................########......##########.......############################################.....###.###################..........###############
##.........#######..................................##########......#............##########...............###########################.....############################################.....######################............##############
##........###########...............................##########...................##########................#########################......####################.#######################.....####################..................##########
##.......##############.............................###########...###...........############...#............########################......######################.######################...####################....................#########
##.....#################.............................##..######....###......####################.............#######################......###################################################################.....................#########
##...####################............................#....#####....##############################.............######################......##################################################################..........###............######
##.##########.....########.................................####...###########..#################................####################......#############...#############################################................###............#####
############.......#######..............###................#################....################...................#################......############.....###########################################.................###.............####
############.......########............####................################.....##############......................###############......#############......#########################################...................##.............####
###########........#########...........####................################.....#############.............#..........##############.......###########.......########################################....................##.............####
###########........#########...........####................#################...#####...######............###.........########..............#########........########################################....................##............#####
######...##.......##########...........####................########################....######............####........#######................#######.........#######################################.....................###...........#####
####..............###########.........####.................###################..........######......#................#######................######.........#....###########################..#####...........#...........#...........######
###....#..........#####..####........#####.................##################............######....#................########................###............#.....#########################....####...........................#......#######
##................#####...###.......######.................#################.............#####.....##..............#########......................................######################......####.................................########
##...............######..####.....#########.................###############..............####.....####.............#########...........................#...........###############.............###................................#########
##..............##############...###########.................#############...............###.....######............##########.......................................#############..............####.................#............##########
##...........################################................#############......................########............#########..............................#.........############..............########..............#...........##########
##............################################................############..#..######..........#########............##########........................................###########..............###########.............#..........#########
##...................#######...################..............##############..###########.......#######..............################..........#.....#..................##########..............############.......................#########
##.........#..........#####.....################...........#############################......####..#..............#################...............#...................######.####............##############......................#########
##....................#####.....####################......##############################......###.................##################......####.........................############......##################......................##########
##......###..........######....########################..################################.....###..............#####################.......##....#........###.........####################################......................###########
##......####.....########################################################.################...#####...........#######################..............#......######......#####################################.....................############
##......#################################################################..#######################..........#########################....................#######....######################################....................#############
##......#################################################################.#########################......###############################................##################################################................#################
##.....############################################################################################......################################...............##################################################..............###################
##....##############################################################################################....##################################.............#####################...###########################.............####################
##.##############################################################################.###################..####################################.........########################..#############################...........#####################
###########################################################################################################################################################################################################################################
###########################################################################################################################################################################################################################################
