###########################################################################################################################################################################################################################################
###########################################################################################################################################################################################################################################
##................#..............##................................######.....##########..........####################################...#....######.....########.............##########################################.######........####
##................##..............##...........#....................######......########...........####################################........#####.....########..............#########################################..#######......####
##................................#.............#...................######........######............###################################.........####......#######...............##########...###########################...#######.....####
##.............................................###..................#######..........##.............#####.############################..........###........######................########.....#####################################...#####
##.............................................#######..............#######..........................##....##########################............##........####..................#######......#############################################
##............................................########..............#######................................#########################..............#.........#....................######......##############################################
##...........................................########...............#######................................###.....################..............................................######.....######..############.########........##########
##..........................................#########...............########..............................###.......##############..............................................#####......######....###########..######............#######
##.........................................##########...............#########...............###.........#####........############..............................................#####.....########....###########..#####................####
##........................................###########...............#########...............###.........#####.........##########...............................................#####.....#########..##################..................###
##........................................###########...............##########..............####.........####..........#########...............................................#####.........#########################..................###
##........................................###########..........#...############.............#####........####..........#########..................................###.........######............#####################...................###
##...............................#####....######...###.......##################.............######........##...........#########...........................#......####........######.............####################..................####
##..............................#####......####.....###....####################.............#######.......##..........##########...........................###....#####.......######...............##################.................#####
##.................#............####.......###.......##########################............#########.................###########........#########.........#####..#######......#####.......#.........##################...............######
##...............................##........##........#########################.........##############...............#############......###########.........#############......####....................#################........############
##...............................#.........##.........##############...#######.........################........#..###############.....#############.........############......###..........................########..###.......############
##...................................##....##..........##########......######..........#################........##################...##############...........###########....####.......####.................#####....###.....####....#####
##...................................####.#............#######.........#####...........#################.......##############........###############...........###########..######.....######......#..........####....####...####......####
##....................................####.............######.........######...........##################.......############...............##########..........#.....#########################.................###....###########......####
##.....................................###.............####..........######.............##################.......##########.........#.......############.............#########################.....#............###..#############....#####
##.....................##..............###..............##...........######..............##################.......########...................###########............###########################.................###################..######
##........#............##..............###.............................###...............#################.........#######...................############...........###########################.....#...........###########################
##.......##............##..............####.............................#................################............#####...................#######....#...........###########################.................###########################
##......###............##..............###........................................#.......##############...............###..................#######................############################.................###########################
##.......##............###.............###...................................#######......##############................##.................#########..............##########.....#############................#############################
##....#...............#####............###..................................########........###########.................#...............############.............##########........###########................#############################
##....................######...........###..................................#########..........########...........................###################...........##########..............######.............################################
##....................######...........###.................................##########...........#######..........................####################.........#########..................#####.........####################################
##....................######...........###.................................##########............#######.........................#####################..#.....#######....................######........####################################
##...................#######...........###..............#..................###########.............######........................#####.....###############....######.........###.........######.......#####################################
##...................#######...........###.............#..................#############.............######......................#####.......###############..#####.......#########.......#######.....######################################
##...................########.....#.....###............##.........#......###############............#######............#.......#####.........########...#########......##############....#######.....###########...................########
##......####.........#########..........####..........##........##################......#######....##########.........###...########.........#######.....#######.......###############..#########....##########.....................#######
##...#######.........#############.......###.........###........#################.......#####################.......################.........#######......######......#######......##..##########...##########......................#######
##..########.........#############........###.......####.........##############............##################......##################.........######......######.....#######...........###########.###########......................#######
##..########.........############..........#......#####............#..########..............#################......##...##############........######......######......######..............####################......................#######
##.....######.........###########.................#####................#######...............########...###..............####.#########.......######......#######......#####................##################.....................########
##......######..........########...................#....................#####.................######.....................################......#####.......######.......#####................#######..########.....................########
##.......######...........#...##........................................#####....................##.......................########.....###.....#####......#....###.......#####...............######......####..............#......#########
##.......######........................................................######.............#...............................#######.......###.....####............##.......#######.............#####........###.......###...........#########
###......#####........................................................#######............###.............................#######.........###.....####............#.......########............####.........##.......####...#.......#########
###......####........................................................########...........####...........................#########..........###....####............##......########..............#..........##........###............########
##.......###......................####...............................#########.........######.........................###########..........###....####...........###....#########.........#...............##.........#..............#######
##......####..........#...........######......###....................########################......#..................############.........####...#####..........#################.##....#................##.........................######
##......####.........#...........#########....#####....#............#########################.......#.................#############........############..........#####################..###...............##..........................#####
##.......####...#...............#########......#############.......###########################......##................###############.....###########...........###########################...............##..........................#####
##.......#########..............#########......###############################################.....####...............##############################...........############################...............##..........................#####
##........#########....####....#########.......###############################################.....#####.............##############################..........###############################.............###..........................#####
##.........############################.......#################################################....######............############################.........###################################...........#####.........................#####
##.........############################.......##################################################..########..........#############################........#####################################.........#######.........###....##......#####
##.........############################......#####################################################################################################......##########################################...##########.......#####..####....######
##........#############################......######################################################################################################....#########################################################....#######################
###########################################################################################################################################################################################################################################
###########################################################################################################################################################################################################################################
