###########################################################################################################################################################################################################################################
###########################################################################################################################################################################################################################################
##.............###................###...................####....................############...........####.######..............#####.##.................##########.....#....########............###########..#######...###.............###
##............####................####.................####......................########....................######............#.######.......................####......##....#######............##########....######....#...............##
##............####................######..............####.................##................................######....################......................#####......###...########.........###########......#####....................##
##............####.................######......#......####................####...............................#########################.......................####.......###....#######........###########.#....######....................##
##............###.............#.....####..............#####............########..............................########################....#...................####.......###.....#######.......##############..######.....................##
##............###............###....###................#####..........#########.............................########################....##......##..........#####........#.........####........####################......................##
##............###.............###....#...................###..........########..................##..........##################....#............####.........#####..................####.........##################.......................##
##.............##.......##....###......................................####....................####.........#####...######....................####...........###....................###...........###############........................##
##.....................####...###............##........................####...................#####.........#####....####.....................####.................................####............#####.#######.....##.................###
##.....................####...##............#####......................####.....######.......######.........####..............##..............####................##.......####....#####............##....#########.####................###
##......................##..................######....................#####....########......######.........###..............####..............###...............####.....######...######.................##############...............####
###.............##..........................#####....#..............###################.....#######.........................#####...............#................####.....################.................#############..............#####
###.............###..........................###....###............##################.......########.......................######......###........................##......#################................#############............#######
##.................................................####...........##################........########.......................######.....#####................................#########....####................#############..........########
##................................................#####..........#################..........########......................#######....######...#.................................####....####.................############.........#########
##.....................................#..........####...........################......##...########.....................########....#####...###................................####.....##..................#############.......##########
##................####...............###..........###.............##############.......###...#######..............###....#######.....####...####...............................####..........................#############......###########
##...............######.............####..............................#########.......####..#########............#####...#######......##...#####...............................####..........................########.####......###########
##.......####....######.............###................................#######.......#####..##########...........######.#######............#####...............................#####......####.....#..........####.............########.###
##.......####.....####......#...........................................#####.......#####...################.....##############............#####.......................#####...####.......#####...............####.............#######..###
##.......##.##.............###.....................................................##########################....##############............####....................##########................###..............#####............#######...##
##.......#####.............####..................##................................#######.#################.....##############............###.#........##.........##########................####..............#####..####.....######....##
##......#####...............###..................####..............................########################.......#############............########....####........###########...............##########.........###########....#####.....##
##......####.....................................##...............................########################........############.............#########...####.........##########..............##############.......##########.....####.....##
##......####...........####......................................................#########################.........##########...............########...###..........#######.###.............###############.......#########....#####.....##
##.....####.......###########.......###..####......................##...........##############......######.........#####.###.........##......#######....#..........#####.#######............#####....#######.....##########...######.....##
##......#........#############.....###########....................####.........########..####........#####.........###..............###......#######.............#####....######............####......#######...####################.....##
##...............##############....###########....................#####.......########....##..........####..........#..............####......#######............#####.......###.............###.......#######...#####################...###
###..............##############....###########....................#####.......###.###............#.....##.........................#####.....#######.............#####.................#.....###.......########.######################..####
####..............############.....###########.....................###............................................................#####....########.............#####................###....####.....######################################
####.....#####.....###########.....##########.....................................................................................####....########..............#####...............####....#####...#######################################
###############........#######.....#########..............###..........................##..............###........................####...#########...............###...............#####.....##########.############..#####################
################.......#######......#######.............#####.........................####............#####........................##....#######.##................................#####.....######################....####################
##.#############........######.......#####............#######.....................#########...........######..............................##########....................#######.....###....##########################...###################
##..############.........#####........###.....##.....########....................##########...........######.................................########..................#########.........#########.###################.............#####.##
##..###########..........####................####...########....................##########.......###...####......................###..........########.................##########.......#########...#################....................##
##...#########...........#####..............#####...########.....................########........##.....###.....................#####........#########......###.........#########........#######......#########..........................##
##....#######............######.............#####....######.......................######........................................#####......##########......#####.........#######......................########...........................##
##.....####..............######.............#####.........................................##....................................####......###########......#####.......................................#######...........................##
##....####...............######.............#####........................................####..............##...............########......##########........####........................................######..........................###
##....####...............######..............###..........................##............#####.............####.........#############.......#########.........##..........................##..............#####.........................####
##.....##................######..........................................###...........######.............####.......###############...........####........................######........####.............###..........................####
##........................####..........................................####...........#######.............###.......##############.............##......##................########........####.........................................####
##...................................................................#######...........########.............##.......##############....................###...............##########........####........................................####
##..................................................................########.......#################.................#############....................####..............############........###.........................................###
##.....................................................##..........########....######################................##############......#............###...............###########.....................................................###
##........#............................................###.......#########....######################.................###############...................#.................#########....................####.............................####
##........................###...#######................####....##########....##############.#######..........##......###############.....................................#########...................######..........................######
##.......................###############...............##################....###################............###.......###############........#...........................#########......#............#######........................#######
##..#..........#........#################.............#########################################.............###......################.......####..................###....#########......##...........########.......................#######
##.....................###################.........################################.##########......................#################.......#####............##.######...##########..######...........##########....................#######
##.........###........####################......###################..############...##########.....................##################......########........#############.###################..........##############.................######
####.....######.###..#####################.##############.########.################..##########..................#####################.##############.#########################################.......####.###########............#####.###
###########################################################################################################################################################################################################################################
###########################################################################################################################################################################################################################################
