###########################################################################################################################################################################################################################################
###########################################################################################################################################################################################################################################
######....................#.....######.....#######.............###########################################################################......#####........############......############################################################
###........................##..#########..#########............#################################################################.....#####.......####.......#############.....#############################################################
##........................######################..#...........#################################################################.......####........###.......#############....#####################################################..#######
##.......................######################...............################################################################........###..........#.........#############..#####################################################....######
##......................########....###########...............################################################################........###....................####################################################################....######
##......................#######.....###########....#.........#################################################################........##.....................#####################################################################..#######
##.....................#######.......###########..###.......#################################################################.........##.....................###########################......#############################################
##..............#......#######........#######################################################################################...#.....##.....................##########################.........###########################################
##.............###....########........######################################################################################.........###......................########################............########################....#############
##.............###############........#####################################################################################.........#####......................######################...............#####################.......###########
##.............################......######################################################################################........#######.....................#####################..................##################..........#########
##..............################....#####################################################################......############.......#############.................####################.......................#############...........########
##................######################################################################################........###########.......###################............###################........................############...........########
##.................####################################################################################..........##########.......###################.............###################........................############.........#########
##.................###################################################################################...........##########.......###################............########.###########.......###...............############.......##########
##.................############################..#####################################################...........###########.....####################...........######################.....####...............#############################
##.................###########################....##########################........##################...........#########........###################..........################################...............#############################
##.................##########################.....#########################...........################...........########..........#.....############........#################################................#############################
##.................#########################......#########################............###############...........#######..................###########.......##################################................#############################
##........###......########################.......####.........############.............###############.........#######...................###########.....#####################################..............##############################
#############.......##...################........####............#########..............###############.........#######...................###########.....#######################################...........###############################
##############............#####...######........####..................###...............################........######....................############.....#########################################.......################################
###############............###.....####.........###.....................................################........######..........##.......############......################################################################################
#####..#########............#......####.........###......................#..............###############.........#####...........#####...############.......###################..###########################################################
####....#########..................####.........###....................................################.........#####..........#####################......###################....##########################################################
###......#########.................####.........###...................................################..........#####....##....#####################.....####################....#########################################.################
###......##########................#####.......#####.................................########.########..........#####....###..######################....######################...##########################################################
###.......##########..................##.........##.......................############################..........######..#############################..####################################################################################
###.......###########.............................#.....................##############################..........###########################################################################################################################
###.........##########...................................##.............#############################...........####################################################################################################..#####################
####.........###########..................................#.............#############################...........#########################...#######################################################################....########.....#######
####...........###########.................................#............#############################...........########################.....######################################################################.....######.......######
####............##########.............................................#############################...........#########################......#####################################################################......####.........#####
####.............##########...........#.....................#.........###########################............##########################.......#####################################################################......####.........#####
#####......##....###########...........#######...............#.......###############..##########............####.######################......##########......####################################################.........####........#####
##############..############..........########...............######################....##########..........####.######################......#########...........#####################.....######################...........##.........#####
############################.........########.................#####################.....#########........############################......########..............##################........####################.......................#####
#############################........####......................####################......########........###########################......########.................###############..........##################.......................######
##...#########################.......##.........................###################........######.........######..#################.......########..................#############............#################......................#######
##.....########################.................................###################............###.........###.....###############.......#########...................############.............################...................##########
##......########################................................####################............###.........#.......#############........#########...................#############............#################.................###########
##.......########################...............................#####################............###.................###########.........#########...................##############...........######....##########........#...#############
##........##########################.........###...............#########################..........####...............############........#########...................##############..........######......##########......##################
##.........###########################......#####.............###########################.........####...............############.......##########...........#.......###############........######........########......###################
##.........#######################################............############################........####...............#############....############..........###.....#################......######.........#######.......###################
##.........########################################..........##############################......####................#############################.........#####...##############################.........#######.......###################
##.........#########################################........###############################.....####.....#...........#############################...#....#######################################.........#######.......###################
##.........###########################################.....################################....#####....####........#############################........########################################........########.......###################
##.........################################################################################...#######..#########################################.........#########################################.....##########.......###################
##.........#################################################################################.##################################################.........#########################################################......####################
##........#####################################################################################################################################.........##########################################################....#####################
###.......#################################################################################################.####################################.......####################################################################################
####.....##################################################################################################################################################################################################################################
###########################################################################################################################################################################################################################################
###########################################################################################################################################################################################################################################
