###########################################################################################################################################################################################################################################
###########################################################################################################################################################################################################################################
##....#........................################........###..#######..#####################################......#######..........#.#####################################################....######################.###.......####....######
##.............................#################.......##...###############################################.....#########...........#########......#############################.....###....##########################......######...######
##...#.........................##################.....###....##############################################.....#########............#######........#################....####.........###....################..######.......#####....######
##...........................#..##################.....#......#############################################.....##########.............#####.........###############.........................###############....#####.......####.....######
##...............................#####.....######.............#########.###################################.....##########..............####..........##############..........................#############.....######......###.....#######
##.#..............................###.......####..............#########..##################################....############..............####..........#############....................#.....############......#########...###....########
#####.......................................#................##########...#################..###############..##############..............###...........############............#..............##########.......################..#########
##.#..............#####.....................................##########....################....###############################..............##............###########...........##...............########........###########################
##...............############.............................############....################....########################.....###........##...#.............############..........###..............#######.........###########################
##...............##############...................#......############.....#####..#########....#######################.................###.................############.........###..............######...........##########################
###.............################.................##.....#############....#####....#########...#######....###########...................###................####...######........###..............######............#########..##############
##.............##################...............##......###########......#####....##########..######......##########....#...............###.................#.....######........##..............######.............#######....#############
###...........##############..###...............##......####...###......######....#################........########.....##...............##.......................########......##.............#######.............#######.....############
#####......################.....................#.......###.....#.......#######..######...########.....#....#######....####....#..........#......................#########......##..........#.#######..............########.....###########
#####......################.............................###.............##..##########.....#######..........######.....#####................#...................###########.....##...........########.........#.....########.....##########
######.....#################..........##.................##.............##...########......#######....#.....#####.......#####.........................#........###########.....####..........########.......##.......######################
#######....#######################...#####...............#..............##....#######.......######.........######........######...............................############....#####...........#######.......##........#####################
########..#####........##########.......................................##....#######.......######........#######........#######.......................##....##############..######...........#######.......#.........#####################
###############.........#########.......................................###...#######......########......########........########......................############...#############...........#######......##..........####################
##.############..........########......................................#####.########.....#########.....###...####.......#########.................##..###########.....############...........###############...........###################
##.#############.........########.............................####....####...########...############...###.....####.....############.#...........###...##########......############.............##############..........###################
##.############..........#########.....................##################....########.###################......#####################.............##....##########......############..............##############.........###################
##############..........#########.#..................#####################....#########################........#################...#...................##########.....#############.............#################.......###################
#############......#############...........#.........######################....#######################.........################.......................############...#############..........#.####################.......######...#########
##...########.....#############......................#######################....#####################..........#################......................###########################............##########........###........####.....########
##....#######....#############.......................####...#########....#####...####################.........###################.........##...........########################..............########...............................#######
##.....#######..#############.................###.....##.....#######.......#############...#########.........###################.........######........#######################...............#######................................#######
##......#####################.................##.............######.........###########.....########.........###################.......##########.......######################.........#.....######.................................#######
##.......####################....#.....................#.....#####...........#########......#######..........##############...#.......############......######################.........##...#######......##.........####..............#####
##........###################....#..........................######............#######......######............#############......#....############..........###################.........###########.......##........######..............####
##.........##################...##..........................#######...........######......######.............#############........#....########...............################.........##########........###......#######..............####
##.........#################...............................#########..........#####.......####..............#############....................#......................##########.........#########.........###......######...............####
##.........################................................##########........#######......###...........#...#############............................................#########........##########.........###......#####........#.......####
##.......##################..........##....................#############....#########.......................#############.............................#...............#########......###########.........###......####.................####
##.....########.###########.........#####..................############################.......................###########............................###..............#########......###########.........##........##..................####
##.....##....#.############........##########...............############################.......................##########.....#####.................###.................########.....###########........###........##..................####
##..#..#........###########......###########.................###############################....................#########....######...............#.###..................#######.....###########.......####.......##........#.........#####
##...............##########################....#..............################################...................#########.....#####................###..................#######......###..#####......####........#.................#######
##...............#########################....................########...######################...................#########.....#####...................................########.......#....####....#####.......#..#...............########
##...............#######.################.....................#################################....................#########.....####............................###############............#####..#####..........................#########
##...............########..##############.....................#################################.....................#########.....####.#........................###########.####............######.#####.........................##########
##...............########################.....................##################################....#................#########...####............................###############............############........................###########
##..............##########################...................#####################...############.....................#########.#####.............................##############............###########.....................###############
##.............#####################...###............############################...##############...................################............................###############......#...############..............#......###############
##............#####################.....###.........#############################....##############...................################............................#####################################..............#......###############
##.....##....######################.....#####.....###############################....##############..................##################...............#............###########..#######################..............#......###############
##....#############################....##########################################......###########.#..............#####################...............#####.........#########....#########.############.....................###############
##...###############################..###########################################................................######################.....#..........######........#######.....########...###########.........#...........###############
##..#####################################....####################################...............................########################................######.......#######....########....###########...........#........################
##.#####################################......####################################.....................#################################................########......######....########....###########..........##########################
########################################......#####################################..................###################################................##########.....#####....########....###########.........###########################
#########################################....#######################################................####################################...............############....######..#########....###########........############################
######################################################################################.............######################################.........##################...########.########....############......#############################
###########################################################################################################################################################################################################################################
###########################################################################################################################################################################################################################################
