###########################################################################################################################################################################################################################################
###########################################################################################################################################################################################################################################
##..................................................................................####..................#################...########..........#...........########............######.........####################.....................###
##.........................................................#...........................#...................###########################.....................#########............#######.......######################...................####
##................................#.........................#....................................#.........##########################......................########.............#######.......##############.########.................#####
##..........................................................##.............................................##########################.......................######..............#######.......########################..............#######
##............#.............##..............................#.#..........###...............................##########################........................#####..............#######........#########################............#######
##...........###...........####......................................########..............................##########################......................########.............#######.........#########################...........#######
##...........##.............####....................................########.....................#.........##########################....#................###########...........#######.........###############..########............######
##............#................##...................................#######....................#####.......###########################.....##..#..........##....#####..........########.........##############....######..............#####
##..........................................####...................########................#########.......###.....###################........#..........##......####.........#########.........##...#########....######...............####
##........................................#######..................#########....##.......##########....................#############..............................###.........#########........##......########..######................####
##......................................###########................################.....###########.....................##########................................###........#########..........#.......##############.................####
##....................................####...#########.............###############......###########......................########.................................###........########....................#############.................####
##.............................#....#####.....#############........##############.......###########......................#######.......#..........................###........#######.......................###########................#####
##.............................##########.........#########..#.....#############............########.....................#######......####.......................####.........#####.........................##########...............######
##............................##########...........#######........##############.............########...................########.....###############..#.........#####.........#####.........................###########...........#########
##............................#########............#######.....#################............##########.................#########......###############.........######...........####.........................############..........#########
##....................#......########..............######......##################......################.............###########........##############.......########...........####........###..............##############.......##########
##.....................##...######..................##..........#################.....##################...........###########.........#############........#######.....###...#####........###.............##################...###########
##.....................#######.........................................#####...#......###################.........############..........############........######.....############.......#####............#######...######################
##......................#####...........................................###..........#####################........###########............###########....#......#.......#############......#####............######.....#####..#######...####
##......................####............................................##..........#######################......###########..............################............###############.....######..............###.....####....#####....####
##......#...............###.............................................##.........#########################....############...............################...........#########....#############...............###...#####....#####....####
##....###..............###.................#............................###.......##########################.....###########................###############...........########.......############..............############...#####....####
##.....###............####................#..............................###.....##########################........#########................########....#............########.........###########......#.......####################....####
###.....##...........#####...............###...............................####.##########################............######................#######............#....########..........###########.....##.......#####################..#####
###.................#######.............####................................###########...##############...............####.................#######.............###########...........##########.......#.......############################
##................#.########...........#####.................................#########........#########..................#......##.........########............###########.............#########.......##......############################
##...................#######..#........#####.......#.........................########..........#########.........................#####....#########............##########................#######.......###....#############################
##....................######..........#####..................................#######............########..........................#################............#########..................######.......####################################
##........#............#####.........#####......#........#...................######..............#######..........................#################............########....................#####......#####################################
##........##...........#####.........#####................#.................#######...............#######.........................#################............########...........#........######....######################################
##.......####..........#####..........###................##.................########...............#######........................#####......#######...........########...........##.......################################################
###.....#####..........#####...........#................####................############...........########.......................##..........###########......###..###..........###......#################################################
#############.........#######..........................######...............#############.........#########.......................#...........############....###....###..........###....########....###############......#......##########
#############.......#########...............#..#......######................#############........###########..................................########..########.....########......#....########......#############...............#########
#############......##########................##.......######...............############.......##############....................###...........#######....#######.....########...........########.......#########...................########
##....#######......###########........................######..#...........#######............##########....#...................####...........#######....######.......########...........#######.......########.....................#######
##.....######.......##########............................................######..............########........................#####...........#######.....#####.....#.....####...............####......########.........................###
##.....######..........########.....................#....................######................######........#............#########............######.....####.............###................####........######........................###
##.....######...........######...........................................#####...........##.....####.....................##########.............#####.....####.............####................#####.........####.......................###
##......####.............###......................#.....................#####...........###......###....................##########...............#####....###..............#####...............#######........####.....................####
##.......##...............#.......................#.....................#####...........####.....###...................##########................#####....##..............#######..............######...........#####.....#...........#####
##.................................#...................................######..........######.....##................#############.................#####..#...............########.............######..............######..............#####
##...............................###..................................########........########....##................#############..................######.............############...........######................#####..............#####
##........#.....................####....................#............##########################..###.................############...................#####............#############..................................####..............#####
##..............................####...#................##..........#################################................#############..................####............##############.......................#...........###..............#####
##......................##......#####..................###........####################################...............###################............####............###############...................................##.............######
##.....................####....######.................#####.....#################################..####..............####################...........####............###############....................................##............######
###.....................##############..............############################################....######...........#######################.........###............###############.......##............##.............##...........#######
####....................###############............############################################.....#######..........##########################.......##...........################......####..........#######.........###...........######
####....................################........################################################...###########......############################.......##........###################....#####..........#########.......####..........######
#####.............##...##################.....###################################################################################################......###....################################........###########......#####.........######
######...#################################...#####################################################################################################.....###########################################...#############....#######.......#######
###########################################################################################################################################################################################################################################
###########################################################################################################################################################################################################################################
