###########################################################################################################################################################################################################################################
###########################################################################################################################################################################################################################################
##....###...............####...#####........#####............########################.....##############.......#######.......############...#############################################...################...#################.........##
##....###.......#.........##..#####.........######............########################...################.......#######.......###########....###############.#########...###############....#################..#################.........##
##.....#......................#####........########.............###########..#############################.......#######..........########.......####################.....##########.###....##################.#################.........##
##......#....................#######...#############.............#########...##############################......#######...........#######........###################.....##########.###....####################################.........##
##..........................###########################..........########.....##############################.....########...........#####.............###############......#############....####################################.........##
##.....................#...####..######################.........#########....################################.....########...........####..............##############......#############.....####################################....#...##
##.................###########....#####################........###########..#########################....#####....#########...........#.................############........###########......###########################.##################
##....#..........#############....#####################........#####################################......#####...#########.............................############.........##########.......#############################################
##..............##############.....#####################......#####################################........#################.#..........................############..........########........###########...###############################
##.............###############.....######################....#####################################..........################............................############...........######..........#########.......#############..#############
##.............###############.....#################.#####..######################################...........###########..............#.................############...........######...........########........###########....############
##............################......############......#########################..#################.............########...............#.................#############..........######............#######.........##########....############
##...........##################.....###########........#########.....#########....####...##########.............#####......................####...........####...#####..###...#######............#######..........#########....############
##..........####################....#..###.####.........#######.......########....###.....##########.............###.......................#####...........##.....####################..........########...........#########...############
##..........#####################.......########.........#####.........######.....###......#########............###........................######.................#####################........#########...........########################
###.........######################......########..........###...........#####.....###......##########.........####.........................#####.................#######################.....###########............#######################
####........######################.......#######..........###............###......###......#########..........####..............#...........####..............##########################....#############................##################
#####.......########...###########.......##...............###............#........####.....#########.........#####.............###..........###.............############################....##############................#################
######......#######.....##########.......#................###.....................#####....#########...........###............#####.........###............#############################....##################............#################
##...###...#######......##########.....#.......#..........##......................######..##########............###..........######.........###.........#############..##################..#####..#############...........#################
##....############......###########.......................##.....................####################............#####.......######..........#####.....#############....#######################....##############.........#################
##....############......############......................###...................###############.######............#####.....########..........######..############......##############..######.....##############..........################
##...############.......############......................######................#######################...........######...########............##################......######..######.....###.....###############..........################
##..#######..####.......############......................#########............########################...........#######.#######...............#################.....######....#####......##....###########...............################
##########...####......########...##.....................##########...........#############...########............##############................##################...######......####........#..###########................######.#########
##....#####..#####....########.....#.....................##########.....#....#############.....#######........#################................###########.################.......###........##############................#####...########
##.....#######################............................#########......################........####.........#################.............################################.................##############...............#####...#########
##.....######################.....................###.....#########.....################.......................#################...........###################################...............##############...............####....#########
##.......###################.....................###......#########.....###############.........................###########..#####........#####################################..............##############..............####....#.########
##..........#####...########.....................###.......########.....##############....................#......#########....######......###########......######################............###############...............#.........######
##...........###.....#######.....................##........#########...####.....#####............................########.....######......##########........#####################...........#######....##########.....................#####
##..........####.....#######......................#........###############......####.............................#######.......#####......#########..........####################..........#######.........##########..................####
##.......########...########..............................################......###........#.............##......#######........####......#########...........###################.....###########................#####..................###
##......####################............#................##################....###...........##..........##......########........###..........####............###################....############.................####..................###
##........###...############..........####...............###################..###............##...................########........#.............##...............#################..#############.................#####.................###
##...............############........######......#.......#######################........#....##....................########.......................................###############################..................#####................###
##................#############.....########.............#######################.......###..###.....................######........................................################################..................####............#..####
##................##############...##########............#######################........#######.....................######......#.................................################################....................#............########
##...............############################.............#######################........######....................#######.............................#..........##################........#######................................########
##...........########..######################...............######################.......######....................#######........................................#################..........#######.....#........................#########
##...........#######....#####################................######################......#######...................########.......................................################...........##############......................##########
##..#........#######....#####################.................######################.....#######...................#########......................................################..........###############...................#############
##...........########..############..########.................######################....#########..................##########......................#...............###############.........################..................##############
##............##...###############....########.......#.......######################...###########..................###########......................................##############.......##################...................#############
##............##...###############....#########....###############################....####...####.................#############....................#................######################################.....................############
##............###.################....##########..###############################......##....####................################............................#.......#####################################.....................############
##......##########################....#####..###################################.......##...#####...............#################........................#######....######################################....................#######..####
##......###########################..#####....#################################........###########.............#############.#####................#.....#########..#######################################...................#######....###
##.....##################################.....###############################..........############...........#####################..................####################################################...............############....###
##....###################################.....##############################..........###.....###########################################............###################################################...............##############..####
##...####################################....##############################.....########.......############################################..........############################################..#####.............######################
##..######################################..##############################.....#########.......###############################################.......###########################################....#####...........#######################
##.#######################################################################....###########.....########################################.########.....############################################....######.........########################
###########################################################################################################################################################################################################################################
###########################################################################################################################################################################################################################################
