###########################################################################################################################################################################################################################################
###########################################################################################################################################################################################################################################
###.#####..............###..............###....######............###########.......##########################......#######.........................########....######################################......######..########################
#######................####........#....####..#######...........#############......##########################......########.........................########..#######################################.....######################..#########
######.................####.......####.###############.........###############....###########################.....##########.............##........##################################################.....#####################....########
#####..................#####.....#####################......##################################################...###########.............##........##################################################.....#####################.....#######
####...................######...######################.....#################################..###############################............##.......###....############################################....######################......######
##.....................################################....################################....##############################.....#......##......###......###############################....#########..#######################.......#####
##............#.......#####################################################################....###############################..........##.......##.......###############..##############.......###############################......######
##............##.....#################################################..################.###..####################################......##......###........#############....#############........##############################.....#######
##............###...############....#################################....######...#####.###########################################....###..................############....#############.........###########################......########
##.............################......################################....#####....########################################...#######..####...................############..##############.........##########################......#########
###............#################.....################################...######....########################......#########.....############....................#######################.............######.###################......#########
##.............##################....################################..#######....#######################........#######......###########.....................######################..............##########.....###########......#########
##.....#......###################################..###########################....######################..........#####.......###########.....####............######################..............#########......###########......#########
##....###.....##################################....###########################..######################............####.......#####...###.....#####...........######################.............#########.......###########......#########
##....##......##################################.....#################################################........#.....###......#####.....##....######...........#######################........#############......#############.....#########
##....##......###################################......#####.....#####################################..............###.....###.........##..#######..........#########################.......#############.....##############.....#########
##...###.....######################################.....###.......##########.....#####################...............##.................###########..........##########################.....#############.....################....#########
#########...##########..###########################......#........#########.......####################..................................##########..........#######.####################...##############....##################.....#######
##########.##########....###############...#########...............#######.........###################................#.................#########...........##############################################..####################.....######
####################.....##############......#..####................#####..........###############.###...................................#######...........######################################################################.....#####
####################.....##############.........#####................###..........####################...........#.......................#######.........#########################################################################...######
####################......##......#####.........#####................##..........###########.##########.........#............#............######.........###############################################################...################
#########...#########..............####.........######..........................#############.##########....................###...........######.........######################..######################################.....###############
##...........########..............####.........#######........................#############################................#####.........#######.......######################....####################################......###############
##...........########..............#####........########......................###############################..............########......###########...#######################....####################################......###############
##..........#########..............#####........##############............#..########################.....#####...........#########.....#######################################..#####################################......###############
##.........###########..............####.........#############............##########################........#####........##########....################################################################################....################
##.........###########...............####........#############........#..###########################.........#######################..#########################################################################.....####..#################
##........#############...............####...............#####.......#..###########################..........#################################################################################################.......########.....#########
##.......###############...............###................####.........##########################............##############################################...################################################........######.......########
##.......################...............###...............####........##########################.............########################....############..###.....###############################################.........#####........#######
##......######..##########...............##................###.......###########################.............#######################.....###########....##.....###############################################..........####........#######
##......####.....#########...............##................###......########...#################............########################.....###########.....##....########################################...####..........####.........######
####...####......#########...............##................####...#########....################............#########################.....###########......##..####################.###################.....##............###..........#####
##########.......#########..............###................################....######..########...........####..####################....############......###########################################......##............####..........####
#########........##########............###................###########.######...#####....#######..........####....###################...############.......##################################...######.....##..............####.........####
########........#############.........###..................##########.#####....####.....#######.........#####....################........#########...........##############################....######....###...............####.......#####
######..........##############.......####..................################...#####.....########.........####....###########..............#######...............####################............#####...####.....#.........#####.....######
####...........###############......#####..................#####################........#######............#.....##########................#####.................##################.............######.#####................#####...#######
##.............################....#######..................###################.........#######...................#########....................#..................################.............#############................###############
##............##################..#########.................###################.........######....................#########........................................##############.............##############.................##############
##...........################################................###################.........#####.....................#########.....###................................############.............################................##############
##.#........##################################...............####################.........###......................###################...............................###########.............#################...............##############
#####......############################.#######..............########################..............................###################................................###########............#################..............###############
#####.......################..########...#######.............##########################............................####################......#..................##.....###########...........##################.............###############
####........########.######....#######....##########........############################.....##...................######################....###.............######.....##############.......###################.............###############
###...........#############....#######....##############...##############################....###.................##############################.............######.....########################################.............#######.#######
###............############....#######....################################################..#####........#####..###############################............########....########################################..............##############
##............##############..########....#########################################################.....#######################################...........##########..########################################...............##############
##...........##########################..#######################################################################################################.........##########################################.....#####................##############
##........#########################################################.#############################################################################.......#####..##############################.####.......####......#.........##############
##........########################################################...######################################################.######################..#########..###################################........###......######....##############
##.......#########################################################...#################################################################.######################..###################################........###......########.###############
###########################################################################################################################################################################################################################################
###########################################################################################################################################################################################################################################
