###########################################################################################################################################################################################################################################
###########################################################################################################################################################################################################################################
##..........................................#..##....#..........########....##################.....#####################################....####...........##############.......#################################################....######
##.............................................###..............########....###################...#####################################.....####...........###############......##################################################..#######
##..............................................###............#########....#############################....#########################.......###...........###############......###########################################################
##..............................................####........#.###########..############.....############.......######################.........##............##############......##########...##############################################
##..............................................####.........#################....####.......###########........####################..........##.............####...............#########.....#############################################
##..............................................####.........################......###.......############........##################............................................#########......#############################.###############
##.............................................#####.........################.......###.......#.....######........################............................................##########......###########################....######....####
##........#...................................######.........################........##..............######........###############...........................................###########......##########################......###.......###
##........##.................................#######.........#################.......##..............######........##############............................................###########......#########################.................###
##........###..........####..................#######........###################......##.............########.......##############............................................############......#######################..................###
##........####........#######...............#########......######################....###............#########......#############.............................................#############......######################..................###
##........#####......##########.............####...###....#######################....###...........##########........###########........#......................#######........##########..........#####################................####
##........######################.....#.....####.....#############################....####.........############........#########.........#####.................########........#########.............####################..............#####
##..........######################.###.....####......###########################.....#################.....##.........#########.........######...............#########........###..###...................###############............#######
##................###############.#####....####.......#########################.......###############.................#########.........#######..............##########.......##....##....................##############...........########
##.....................#########...####....#####.......######################.........###############................#########..........########..............#########.......##....###....................#############..........#########
##..................................###...######.......####################............###############..............#########...........##########............#########.......##....#########...............############........###########
##...................................############......#####....##########..............###############............##########..........#############...........########......###....##########...............###########.......############
##....................................#########........####......########...............###############...........###########..........#############...........#########....#####..###########................##########.......#####.######
##....................................####..............###.......#######................##############...........##########...........##############..........##########..###################....#............#########......#####..######
##....................................###................##........#####.................##############...........#########................###########........################################.................##########....######.#######
##...................................####................#..........#.....................#############............########................###########.......#################################.................############################
##..................................######................................................#############......#......########...............###########......##################################................#############################
##................................########................................................#############.....##.......########.............###########......###################################................#############################
##...............................#......#..................................................############.....###......#######.............############.....#####################################..............##############################
##..........................................................................................###########.....####......#####.............#############.....######################################............###############################
##......................##.....................................................#.............##########......##........###............###############.....######################..##############...........################################
##..#..................####.................................................#####...........############.....#.....................###################...######################....#############..........#################################
##.....................#####.............................................###########.......#############.......................################################################....#############........###################################
##.#..................#######............................................###########.....###############......................########....######################################..##############.......####################################
##...................#########..........#...............................#############..################......................########......######################...#############################.....###########################...#######
##...................###########.......###..............................###############################.....................#########.......####################.....#############################...###########......##########.....######
##..........#.#.....############........##..............................#######################..#####...............##....##########........###################......#############################.##########.........########......######
##.........###.......###########.........##............................#############.....######..####...............#################........###################......#######################################..........####..........######
##........####.......############........##...........####.........################.......##########...............##################.........##################.....###############...#####################..........####...........######
##.......#####........###########........#...........#####........#################........########...............####################........##################....###############.....###################..........####............######
###......#####........###########.......#.........................################..........######................####################........#################.....#######.######......###################.........####.............######
###......######........##########..................................##############...........#####.................####################........#################.....#############.......###################.........###..............######
##.......######.........########....................................#############..........######.................#.###################.......#########..............############.......##############................#..............######
##.......#####..........#####........................................###########..........#######.....................#####################..#########................###########........############.....................#....###..#######
##.......####...........####..........................................########...........#######.......................#############..#################................###########...........########...........................###########
##.......####...........###........##.................................#######........#..#######........................############....################.................#############.........#######............................##########
##.......###...........####.......####................................#######....#############.........................###########......###############.................##############.........######.............................#########
##.......###..........#####......#####.........#.....................########################..........................###########......###############.................###############........#####...............................########
##.......####.........#####......######..........................###########################...........................############.....###############................###################....######................#.#.............#######
##......#########.....#####.....#######.........................############################......###..................#############...###############................##############################................................#######
##.......#########...######....########.......................##############################......####.................##############################..............#################################................................#######
##........##################..##########.......#####.........################################....#####................#############################........#########################################........##.........#...........########
##.........#############################.....#################################################..######...............#############################........###################################..####......######.......##..........#########
##..........############################.....#########################################################..............##############################.......###################################....###......#######....####.......############
##..........############################.....##########################################################...........################################.......###################################....###.....#################......############
##.........#############################....######################################################################################################......#####################################...####...###################....#############
##.##.....###############################..#######################################################################################################.....####################################################################..##############
###########################################################################################################################################################################################################################################
###########################################################################################################################################################################################################################################
